80 80
00000000000000000000000000000000000000000000000000000000000000000000000000000000
00000000000000000000000000000000000000000000000000000000000000000000000000000000
00000000000000000000000000000000000000000000000000000000000000000000000000000000
00000000000000000000000000000000000000000000000000000000000000000000000000000000
00000000000000000000000000000000000000000000000000000000000000000000000000000000
00000000000000000000000000000000000000000000000000000000000000000000000000000000
00000000000000000000000000000000000000000000000000000000000000000000000000000000
00000000000000000000000000000000000000000000000000000000000000000000000000000000
00000000000000000000000000000000000000000000000000000000000000000000000000000000
00000000000000000000000000000000000000000000000000000000000000000000000000000000
00000000000000000000000000000000000000000000000000000000000000000000000000000000
00000000000000000000000000000000000000000000000000000000000000000000000000000000
00000000000000000000000000000000000000000000000000000000000000000000000000000000
00000000000000000000000000000000000000000000000000000000000000000000000000000000
00000000000000000000000000000000000000000000000000000000000000000000000000000000
00000000000000000000000000000000000000000000000000000000000000000000000000000000
00000000000000000000000000000000000000000000000000000000000000000000000000000000
00000000000000000000000000000000000000000000000000000000000000000000000000000000
00000000000000000000000000000000000000000000000000000000000000000000000000000000
00000000000000000000000000000000000000000000000000000000000000000000000000000000
00000000000000000000000000000000000000000000000000000000000000000000000000000000
00000000000000000000000000000000000000000000000000000000000000000000000000000000
00000000000000000000000000000000000000000000000000000000000000000000000000000000
00000000000000000000000000000000000000000000000000000000000000000000000000000000
00000000000000000000000000000000000000000000000000000000000000000000000000000000
00000000000000000000000000000000000000000000000000000000000000000000000000000000
00000000000000000000000000000000000000000000000000000000000000000000000000000000
00000000000000000000000000000000000000000000000000000000000000000000000000000000
00000000000000000000000000000000000000000000000000000000000000000000000000000000
00000000000000000000000000000000000000000000000000000000000000000000000000000000
00000000000000000000000000000000000000000000000000000000000000000000000000000000
00000000000000000000000000000000000000000000000000000000000000000000000000000000
00000000000000000000000000000000000000000000000000000000000000000000000000000000
00000000000000000000000000000000000000000000000000000000000001000000000000000000
00000000000000000000000000000000000000000000000000000000000011000000000000000000
00000000000000000000000000000000000000000000000000000000000010000000000000010000
00000000000000000000000000000000000000000000000000000000000110000000000000011000
00000000000000000000000000000000000000000000000000000000000110000000000000011000
00000000000000000000000000000000000000000000000000000000001110000000000001110000
00000000000000000000000000000000000000000000000000000000001111001000111111100000
00000000000000000000000000000000000000000000000000000001111111111111111110111000
00000000000000000000000000000000000000000000000000000000111111000111111000001000
00000000000000000000000000000000000000000000000000000000011110000000100000000000
00000000000000000000000000000000000000000000000001100000001110011000000000000000
00000000000000000000000000000000000000000000110111110011011111111100000000000000
00000000000000000000000000000000000000000000011111110111111111111100000000000000
00000000000000000000000000000000000000000000001111100001111111100000000000000000
00000000000000000000000000000000000000000010000111000000000111100000000000000000
00000000000000000000000000000000000000000010000100011111001111000000000000000000
00000000000000000000000000000000000000111110001100111111000111000010000000000000
00000000000000000000000000000000000000111111111001111111100111111110000000000000
00000000000000000000000000000000000000011111110001101111111111111000000000000000
00000000000000000000000000000000000000001111100011001111111100000000000000000000
00000000000000000000000000000000000000001111100011001111101100000000000000000000
00000000000000000000000000000000000100011101111001111011001110000010000000000000
00000000000000000000000000000000000100001111111001111011000111111110000000000000
00000000000000000000000000000000000100001111111001110001100011111000000000000000
00000000000000000000000000000000001110011111111011100011110000010000000000000000
00000000000000000000000000000000001111111111110111100111110000011000000000000000
00000000000000000000000000000000000111111100110111111111111111111100000000000000
00000000000000000000000000000000001111111100011111211111100111111100000000000000
00000000000000000000000000000000001111111100011111111101100111111100000000000000
00000000000000000000000000000000001100111111111100111000100011111000000000000000
00000000000000000000000000000000001100001111111100011100011111000000000000000000
00000000000000000000000000000000001100001100011000111111111110010000000000000000
00000000000000000000000000000000001110001000011001110011111111011110000000000000
00000000000000000000000000000000001110011000110001100001110011110100000000000000
00000000000000000000000000000000001110010000110001111000100110000000000000000000
00000000000000000000000000000000000000010000110001111111011100000000000000000000
00000000000000000000000000000000000000011000111111100011001110000000000000000000
00000000000000000000000000000000000000001000111111110001111111000000000000000000
00000000000000000000000000000000000000000000111110011001111110000000000000000000
00000000000000000000000000000000000000000001110100001100011000000000000000000000
00000000000000000000000000000000000000000000100100001110000000000000000000000000
00000000000000000000000000000000000000000000000000011111000000000000000000000000
00000000000000000000000000000000000000000000000001110011000000000000000000000000
00000000000000000000000000000000000000000000000001000001100000000000000000000000
00000000000000000000000000000000000000000000000000000000100000000000000000000000
00000000000000000000000000000000000000000000000000000000000000000000000000000000
00000000000000000000000000000000000000000000000000000000000000000000000000000000
