80 80
00000000000000000000000000000000000000000000000000000000000000000000000000000000
00000000000000000000000000000000000000000000000000000000000110001110111111111100
00000000000000000000000000000000000000000000000000000000000110001111111111111110
00000000000000000000000000000000000000000000000000000000000111111100111111111110
00000000000000000000000000000000000000000000000000000000000111111100011111111110
00000000000000000000000000000000000000000000000000100011111111111110011101111110
00000000000000000000000000000000000000000000000000100111111111100011011111111110
00000000000000000000000000000000000000000000000000100110111111000000111000000100
00000000000000000000000000000000000000000000000000100011111110000000011000000000
00000000000000000000000010000000000000000000000000100001111111000000001110010000
00000000000000000000000011100000000000000000000000100001010111011111001111110000
00000000000000000000000000110000000000000000000000100001110111011001111111110000
00000000000000000000000000111000000000000000000001100000001111110000101111000000
00000000000000000000000001111000000000000000000011000000011111111000100110000000
00000000000000000000000001111110000000000000010110111000110110001100100011000000
00000000000000000000000001111111000100000000111111111111100011100100011111111110
00000000000000000000000011100111001100000000110011000010000011100100000000000110
00000000000000000000001111000011111000000000100000000000000011011110000000000000
00000000000000000000100000000111100000000000100000000100000010001111000000000000
00000000000000000001100001001011000111000001110000111111000010000100000000000000
00000000000000000000100001101111001110011111111111111011000010000100000000000000
00000000000000000000110001111110011100001111111111110001100010000100000000000000
00000000000000000000010000111111111000000011111111110001101110000000000000000000
00000000000000000000011000011111110000000011111000011001111111100000000000000000
00000000000000000000011001111111111100001100110000111001111111111000000000000000
00000000000000000001111111111111111111011100011001110001101111111110000000000000
00000000000000000011100110001111111011111000011111100011001111100010000000000000
00000000000000000110101100001110010000110000001110000111100000000000000000000000
00000000000000000000111000001110010000100000001000001111000000000000000000000000
00000000000000000000110000111110000000111000011001111111000001100000000000000000
00000000000000000001111011110110000111111100111111110001000111100000000000000000
00000000000000000001100111010011000011001100110011111001111100000000000000000000
00000000000000000111110111001111000001001111111111111000111000000000000000000000
00000000000000000111100011111110000001111111111111001100011000000000000000000000
00000000000001111111100001100000000001111001121111100011111100000000000000000000
00000000000000111100100011100000000000001001111101110011111110000000000000000000
00000000000000011000100010000000000000001000000000110011110000000000000000000000
00000000000000000001100000000000000000000000000001111111100000000000000000000000
00000000000000000000000000000000000000000000000011110011100000000000000000000000
00000000000000000000000000000000000000000000000000110001000000000000000000000000
00000000000000000000000000000000000000000000000000110001000000000000000000000000
00000000000000000000000000000000000000000000000001100011000000000000000000000000
00000000000000000000000000000000000000000000000000000010000000000000000000000000
00000000000000000000000000000000000000000000000000000000000000000000000000000000
00000000000000000000000000000000000000000000000000000000000000000000000000000000
00000000000000000000000000000000000000000000000000000000000000000000000000000000
00000000000000000000000000000000000000000000000000000000000000000000000000000000
00000000000000000000000000000000000000000000000000000000000000000000000000000000
00000000000000000000000000000000000000000000000000000000000000000000000000000000
00000000000000000000000000000000000000000000000000000000000000000000000000000000
00000000000000000000000000000000000000000000000000000000000000000000000000000000
00000000000000000000000000000000000000000000000000000000000000000000000000000000
00000000000000000000000000000000000000000000000000000000000000000000000000000000
00000000000000000000000000000000000000000000000000000000000000000000000000000000
00000000000000000000000000000000000000000000000000000000000000000000000000000000
00000000000000000000000000000000000000000000000000000000000000000000000000000000
00000000000000000000000000000000000000000000000000000000000000000000000000000000
00000000000000000000000000000000000000000000000000000000000000000000000000000000
00000000000000000000000000000000000000000000000000000000000000000000000000000000
00000000000000000000000000000000000000000000000000000000000000000000000000000000
00000000000000000000000000000000000000000000000000000000000000000000000000000000
00000000000000000000000000000000000000000000000000000000000000000000000000000000
00000000000000000000000000000000000000000000000000000000000000000000000000000000
00000000000000000000000000000000000000000000000000000000000000000000000000000000
00000000000000000000000000000000000000000000000000000000000000000000000000000000
00000000000000000000000000000000000000000000000000000000000000000000000000000000
00000000000000000000000000000000000000000000000000000000000000000000000000000000
00000000000000000000000000000000000000000000000000000000000000000000000000000000
00000000000000000000000000000000000000000000000000000000000000000000000000000000
00000000000000000000000000000000000000000000000000000000000000000000000000000000
00000000000000000000000000000000000000000000000000000000000000000000000000000000
00000000000000000000000000000000000000000000000000000000000000000000000000000000
00000000000000000000000000000000000000000000000000000000000000000000000000000000
00000000000000000000000000000000000000000000000000000000000000000000000000000000
00000000000000000000000000000000000000000000000000000000000000000000000000000000
00000000000000000000000000000000000000000000000000000000000000000000000000000000
00000000000000000000000000000000000000000000000000000000000000000000000000000000
00000000000000000000000000000000000000000000000000000000000000000000000000000000
00000000000000000000000000000000000000000000000000000000000000000000000000000000
00000000000000000000000000000000000000000000000000000000000000000000000000000000
