80 80
00000000000000000000000000000000000000000000000000000000000000000000000000000000
00000000000000000000000000000000000000000000000000000000000000000000000000000000
00000000000000000000000000000000000000000000000000000000000000000000000000000000
00000000000000000000000000000000000000000000000000000000000000000000000000000000
00000000000000000000000000000000000000000000000000000000000000000000000000000000
00000000000000000000000000000000000000000000000000000000000000000000000000000000
00000000000000000000000000000000000000000000000000000000000000000000000000000000
00000000000000000000000000000000000000000000000000000000000000000000000000000000
00000000000000000000000000000000000000000000000000000000000000000000000000000000
00000000000000000000000000000000000000000000000000000000000000000000000000000000
00000000000000000000000000000000000000000000000000000000000000000000000000000000
00000000000000000000000000000000000000000000000000000000000000000000000000000000
00000000000000000000000000000000000000000000000000000000000000000000000000000000
00000000000000000000000000000000000000000000000000000000000000000000000000000000
00000000000000000000000000000000000000000000000000000000000000000000000000000000
00000000000000000000000000000000000000000000000000000000000000000000000000000000
00000000000000000000000000000000000000000000000000000000000000000000000000000000
00000000000000000000000000000000000000000000000000000000000000000000000000000000
00000000000000000000000000000000000000000000000000000000000000000000000000000000
00000000000000000000000000000000000000000000000000000000000000000000000000000000
00000000000000000000000000000000000000000000000000000000000000000000000000000000
00000000000000000000000000000000000000000000000000000000000000000000000000000000
00000000000000000000000000000000000000000000000000000000000000000000000000000000
00000000000000000000000000000000000000000000000000000000000000000000000000000000
00000000000000000000000000000000000000000000000000000000000000000000000000000000
00000000000000000000000000000000000000000000000000000000000000000000000000000000
00000000000000000000000000000000000000000000000000000000000000000000000000000000
00000000000000000000000000000000000000000000000000000000000000000000000000000000
00000000000000000000000000000000000000000000000000000000000000000000000000000000
00000000000000000000000000000000000000000000000000000000000000000000000000000000
00000000000000000000000000000000000000000000000000000000000000000000000000000000
00000000000000000000000000000000000000000000000000000000000000000000000000000000
00000000000000000000000000000000000000000000000000000000000000000000000000000000
00000000000000000000000000000000000000000000000000000000000000000000000000000000
00000000000000000000000000000000000000000000000000000000000000000000000000000000
00000000000000000000000000000000000000000000000000000000000000000000000000000000
00000000000000000000000000000000000000000000000000000000000000000000000000000000
00000000000000000000000000000000000000000000000000000000000000000000000000000000
00000000000000000000000000000000000000000000000000000000000000000000000000000000
00000000000000000000000000000000000000000000000000000000000000000000000000000000
00000000000000000000000000000000000000000000000000000000000000000000000000000000
00000000000000000000000000000000000000000000000000000000000000000000000000000000
00000000000000000000000000000000000000000000000000000000000000000000000000000000
00000000000000000000000000000000000000000000000000000000000000000000000000000000
00000000000000000000000000000001100100000000000000000000000000000000000000000000
00000000000000000000000000000111111111000000000000000000000000000000000000000000
00000000000000000000000000001111100011000000000000000000000000000000000000000000
00000000000000000000000000000111100000000000000000000000000000000000000000000000
00000000000000000000000000000110000000000000000000000000000000000000000000000000
00000000000000000000000001000110000000000000000000000000000000000000000000000000
00000000000000000000000011001111000000000000000000000000000000000000000000000000
00000000000000000000000001111011000000000000000000000000000000000000000000000000
00000000000000000000000000111001100000000000000000000000000000000000000000000000
00000000000000000000000000110111000000000100000000000000000000000000000000000000
00000000000000000000000011110011000000001100000000000000000000000000000000000000
00000000000000000000000111110111000000001000000000000000000000000000000000000000
00000000000000000000000111100110000000011000000000000000000000000000000000000000
00000000000000000000000001100111100001111000000000000000000000000000000000000000
00000000000000000000000000100011100001111100000000000000000000000000000000000000
00000000000000000000100000110111111110011111000000000000000000000000000000000000
00000000000000000000100011111111111111011111111000000000000000000000000000000000
00000000000000000000110010001111001111011110000000000000000000000000000000000000
00000000000000000001100000001110000000000010000000000000000000000000000000000000
00000000000100000001100011111111000000000010000000000000000000000000000000000000
00000000001110000001100011111111111110000110000000000000000000000000000000000000
00000000001111111101111111111111111111111100000000000000000000000000000000000000
00000000011111101111111111110000001111110000000000000000000000000000000000000000
00000000110000000111111111000000001111000000000000000000000000000000000000000000
00000000000000000110001111000000011100000110000000000000000000000000000000000000
00000000001001100111111111001110111100011110010000000000000000000000000000000000
00000000001101111111111011110111111100011111110000000000000000000000000000000000
00000000001111001111100001100011100110111110010000000000000000000000000000000000
00000000001111100011000000000000000011110011111000000000000000000000000000000000
00000000011111111001100000000000111100000001110000000000000000000000000000000000
00000000011100111001101111100011101100000001110000000000000000000000000000000000
00000000011100111000111111111111000100111100111100000000000000000000000000000000
00000000001100110000111121111110000110100000000110000000000000000000000000000000
00000000000000111000111111111000000011100000000000000000000000000000000000000000
00000000000111111111001111000000000001111100000000000000000000000000000000000000
00000000000000000000000000000000000000000000000000000000000000000000000000000000
