80 80
00000000000000000000000000000000000000000000000000000000000000000000000000000000
00000000000000000000000000000000000000000000000000000000000000000000000000000000
00000000000000000000000000000000000000000000000000000000000000000000000000000000
00000000000000000000000000000000000000000000000000000000000000000000000000000000
00000000000000000000000000000000000000000000000000000000000000000000000000000000
00000000000000000000000000000000000000000000000000000000000000000000000000000000
00000000000000000000000000000000000000000000000000000000000000000000000000000000
00000000000000000000000000000000000000000000000000000000000000000000000000000000
00000000000000000000000000000000000000000000000000000000000000000000000000000000
00000000000000000000000000000000000000000000000000000000000000000000000000000000
00000000000000000000000000000000000000000000000000000000000000000000000000000000
00000000000000000000000000000000000000000000000000000000000000000000000000000000
00000000000000000000000000000000000000000000000000000000000000000000000000000000
00000000000000000000000000000000000000000000000000000000000000000000000000000000
00000000000000000000000000000000000000000000000000000000000000000000000000000000
00000000000000000000000000000000000000000000000000000000000000000000000000000000
00000000000000000000000000000000000000000000000000000000000000000000000000000000
00000000000000000000000000000000000000000000000000000000000000000000000000000000
00000000000000000000000000000000000000000000000000000000000000000000000000000000
00000000000000000000000000000000000000000000000000000000000000000000000000000000
00000000000000000000000000000000000000000000000000000000000000000000000000000000
00000000000000000000000000000000000000000000000000000000000000000000000000000000
00000000000000000000000000000000000000000000000000000000000000000000000000000000
00000000000000000000000000000000000000000000000000000000000000000000000000000000
00000000000000000000000000000000000000000000000000000000000000000000000000000000
00000000000000000000000000000000000000000000000000000000000000000000000000000000
00000000000000000000000000000000000000000000000000000000000000000000000000000000
00000000000000000000000000000000000000000000000000000000000000000000000000000000
00000000000000000000000000000000000000000000000000000000000000000000000000000000
00000000000000000000000000000000000000000000000000000000000000000000000000000000
00000000000000000000000000000000000000000000000000000000000000000000000000000000
00000000000000000000000000000000000000000000000000000000000000000000000000000000
00000000000000000000000000000000000000000000000000000000000000000000000000000000
00000000000000000000000000000000000000000000000000000000000000000000000000000000
00000000000000000000000000000000000000000000000000000000000000000000000000000000
00000000000000000000000000000000000000000000000000000000000000000000000000000000
00000000000000000000000000000000000000000000000000000000000000000000000000000000
00000000000000000000000000000000000000000000000000000000000000000000000000000000
00000000000000000000000000000000000000000000000000000000000000000000000000000000
00000000000000000000000000000000000000000000000000000000000000000000000000000000
00000000000000000000000000000000000000000000000000000000000000000000000000000000
00000000000000000000000000000000000000000000000000000000000000000000000000000000
00000000000000000000000000000000000000000000000000000000000000000000000000000000
00000000000000000000000000000000000000000000000000000000000000000000000000000000
00000000000000000000000000000000000000000000000000000000000000000000000000000000
00000000000000000000000000000000000000000000000000000000000000000000000000000000
00000000000000000000000000000000000000000000000000000000000000000000000000000000
00000000000000000000000000000000000000000000000000000000000000000000000000000000
00000000000000000000000000000000000000000000000000000000000000000000000000000000
00000000000000000000000000000000000000000000000000000000000000000000000000000000
00000000000000000000000000000000000000011110000000000000000000000000000000000000
00000000000000000000000000000000000000000011000000010000000000000000000000000000
00000000000000000000000000000000000000000110000000010000000000000000000000000000
00000000000000000000000000000000000000011110000000010000000000000000000000000000
00000000000000000000000000000000000000011011000000110000000000000000000000000000
00000000000000000000000000000000000000011111111000100000000000000000000000000000
00000000000000000000000000000000000000001111000111100000000000000000000000000000
00000000000000000000000000000000000000000110000011100000000111110000000000000000
00000000000000000000000000000000001000000011000001110000001100000000000000000000
00000000000000000000000000000000001100010001110001100011001000000000000000000000
00000000000000000000000000000000001110011110110000100001111111100000000000000000
00000000000000000000000000000000001110000111111000110000111000000000000000000000
00000000000000000000000000000000011110000011111000110000011000000000000000000000
00000000000000000000000000000000000011000100111000110000001000000000000000000000
00000000000000000000000000000000000111111110011100110001111100000000000000000000
00000000000000000000000000000000001110011110111101100011111111000000000000000000
00000000000000000000000000000000001000001111110011100011110011000000000000000000
00000000000000000000000000000000000000000011100011100011110001100000000000000000
00000000000000000000000000000000000000000011100111110011111111111000000000000000
00000000000000000000000000000000000000000000111111110011111111101100000000000000
00000000000000000000000000000000000000000000111101110011111111100100000000000000
00000000000000000000000000000000000000000000011001110111111111000110000000000000
00000000000000000000000000000000000000000000111000111111211110000111000000000000
00000000000000000000000000000000000000000000011100111111111100001111111000000000
00000000000000000000000000000000000000111000011100111111111110111110011000001100
00000000000000000000000000000000000000111100111001111111111111111110011100111000
00000000000000000000000000000000000000001111100011100111100111111110001111110000
00000000000000000000000000000000000000000010000010000111000111111011100011000000
00000000000000000000000000000000000000000000000010000011101111111111111000000000
00000000000000000000000000000000000000000000000000000000000000000000000000000000
