80 80
00000000000000000000000000000000000000000000000000000000000000000000000000000000
00000000000000000000000000000000000000000000110001111000000000000000000000000000
00000000000000000000000000000000000000000000110001111100000000000000000000000000
00000000000000000000000000000000000000000000110011111110000000000000000000000000
00000000000000000000000000000000000000000000110011111111000000000000000000000000
00000000000000000000000000000000000000000000111111111011000011000000000000000000
00000000000000000000000000000000000000000000011110011011000001110000000000000000
00000000000000000000000000000000000000000000011000011011000001100000000000000000
00000000000000000000000000000000000000000000111000010011000011100000000000000000
00000000000000000000000000000000000000011000111000000001000010110000000000000000
00000000000000000000000000000000000000001100011000000001000010111100000000000000
00000000000000000000000000000000000000001100111000000001000011111000000000000000
00000000000000000000000000000000000000001111110000000011000011000000000000000000
00000000000000000000000000000000000000111100000000010111000110000000000000000000
00000000000000000000000000000000000000001100011100111111001110000111100000000000
00000000000000000000000000000000000000001000011111111111111010000110111000000000
00000000000000000000000000000000000000000000000011100001110011001100000000000000
00000000000000000000000000000000000000000000000000000000001111001110000000000000
00000000000000000000000000000000000000000000000000000000000110000111110000000000
00000000000000000000000000000000000000000000000000011111000110000111111000000000
00000000000000000000000000000000000000000000000001110011111111001111111000000000
00000000000000000000000000000000000000000000000000000001110111001101111000000000
00000000000000000000000000000000000000000000000000000000001111001000000000000000
00000000000000000000000000000000000000000000000000000000011111111100000000000000
00000000000000000000000000000000000000000000000000000001111111111100001000000000
00000000000000000000000000000000000000000000000000000011111111111110001000000000
00000000000000000000000000000000000000000000000000000011011110001110011000000000
00000000000000000000000000000000000000000000000000000000001100011111110000000000
00000000000000000000000000000000000000000000000000000000011110011111100000000000
00000000000000000000000000000000000000000000000000000001100111111111110010000000
00000000000000000000000000000000000000000000000000000011100011111110011110000000
00000000000000000000000000000000000000000000000000000011000011111100000000000000
00000000000000000000000000000000000000000000000000001110000111111100000000000000
00000000000000000000000000000000000000000000000000001110000110011100000000000000
00000000000000000000000000000000000000000000000000111111000110011110000111001000
00000000000000000000000000000000000000000000000001111111100111011110011111111000
00000000000000000000000000000000000000000000000011111111100011001110010000110000
00000000000000000000000000000000000000000000000011111111100111000000100000111100
00000000000000000000000000000000000000000000000010111011111111100000100000011100
00000000000000000000000000000000000000000000000010111011111111111001111100111000
00000000000000000000000000000000000000000000111111111111111111101111111101111000
00000000000000000000000000000000000000000001000111111111111110000111111111111000
00000000000000000000000000000000000000000001101110011000111100001111111111000000
00000000000000000000000000000000000000000000111100110000001110011111111111000000
00000000000000000000000000000000000000000000011100100001100110011111011111110000
00000000000000000000000000000000000000000001111100100011110111011111011111111000
00000000000000000000000000000000000000000000110100110011010011001110111100110000
00000000000000000000000000000000000000000001100000011110010011100000111001100000
00000000000000000000000000000000000000000001000000001000110001100011111111110000
00000000000000000000000000000000000000000001100000111001110011101111111111110000
00000000000000000000000000000000000000000000111111111111101111001111121111110000
00000000000000000000000000000000000000000000000011001111101110001111111111110000
00000000000000000000000000000000000000000000000000000111111111011111111111000000
00000000000000000000000000000000000000000000000000000111111111101111111100000000
00000000000000000000000000000000000000000000000100000111001111001111011000000000
00000000000000000000000000000000000000000000111111111011101111001111011000000000
00000000000000000000000000000000000000000000000000001001110111101111001000000000
00000000000000000000000000000000000000000000000000001111110001100111110000000000
00000000000000000000000000000000000000000000000000000011111000110011100000000000
00000000000000000000000000000000000000000000000001100001111110000000000000000000
00000000000000000000000000000000000000000000000001111111101111000000000000000000
00000000000000000000000000000000000000000000000000111100000011000000000000000000
00000000000000000000000000000000000000000000000000011100000000000000000000000000
00000000000000000000000000000000000000000000000000000000000000000000000000000000
00000000000000000000000000000000000000000000000000000000000000000000000000000000
00000000000000000000000000000000000000000000000000000000000000000000000000000000
00000000000000000000000000000000000000000000000000000000000000000000000000000000
00000000000000000000000000000000000000000000000000000000000000000000000000000000
00000000000000000000000000000000000000000000000000000000000000000000000000000000
00000000000000000000000000000000000000000000000000000000000000000000000000000000
00000000000000000000000000000000000000000000000000000000000000000000000000000000
00000000000000000000000000000000000000000000000000000000000000000000000000000000
00000000000000000000000000000000000000000000000000000000000000000000000000000000
00000000000000000000000000000000000000000000000000000000000000000000000000000000
00000000000000000000000000000000000000000000000000000000000000000000000000000000
00000000000000000000000000000000000000000000000000000000000000000000000000000000
00000000000000000000000000000000000000000000000000000000000000000000000000000000
00000000000000000000000000000000000000000000000000000000000000000000000000000000
00000000000000000000000000000000000000000000000000000000000000000000000000000000
00000000000000000000000000000000000000000000000000000000000000000000000000000000
