80 80
00000000000000000000000000000000000000000000000000000000000000000000000000000000
00000000000000000000000000000000000000000000000000000000000000000000000000000000
00000000000000000000000000000000000000000000000000000000000000000000000000000000
00000000000000000000000000000000000000000000000000000000000000000000000000000000
00000000000000000000000000000000000000000000000000000000000000000000000000000000
00000000000000000000000000000000000000000000000000000000000000000000000000000000
00000000000000000000000000000000000000000000000000000000000000000000000000000000
00000000000000000000000000000000000000000000000000000000000000000000000000000000
00000000000000000000000000000000000000000000000000000000000000000000000000000000
00000000000000000000000000000000000000000000000000000000000000000000000000000000
00000000000000000000000000000000000000000000000000000000000000000000000000000000
00000000000000000000000000000000000000000000000000000000000000000000000000000000
00000000000000000000000000000000000000000000000000000000000000000000000000000000
00000000000000000000000000000000000000000000000000000000000000000000000000000000
00000000000000000000000000000000000000000000000000000000000000000000000000000000
00000000000000000000000000000000000000000000000000000000000000000000000000000000
00000000000000000000000000000000000000000000000000000000000000000000000000000000
00001001000000000000000000000000000000000000000000000000000000000000000000000000
00011111000000000000000000000000000000000000000000000000000000000000000000000000
00111110000000000000000000000000000000000000000000000000000000000000000000000000
01111111111100000000000000000000000000000000000000000000000000000000000000000000
01111111110000000000000000000000000000000000000000000000000000000000000000000000
01110111000000000000000001000000000000000000000000000000000000000000000000000000
01100111000000000000000001000000000000000000000000000000000000000000000000000000
00000111001110000000000001000110000000000000000000000000000000001000000000000000
01111111111110000000000001100111000000000000000000000000000000001110000000000000
01111111111000000000000001000111000000000000000000000000000000000111000000000000
01111111110000000000000011000111000000000000000000000000000000000111100000000000
01110001110000000000000111100110000000000000000000000000000000111110000000000000
01111100011000000000001111111110000000000000000000000000000000001110110000000000
01111111011000010000111111111110000000000000000000000000000011111111111000000000
01100111001000011000011111111111000000000000000000000000000001111111100000000000
00010111000000001000000111111111000000000000000000000000000011111111000000000000
00011110000000001100001111111111100000000000000000000000000000111111000000000000
00001110000000010110011111111111100000000000000000000000000010111110000000000000
01111110011110010011110011100111000000000000000000000000000011111110000000010000
01111111110010011011100000000110000000000000000000000000000011111100000000010000
00111000100001001110000000000010000000000000000000000000000111111000000011110000
00111000100011000000000000110010000000000000000000000100000111110000000001100000
00111101101111110000100001110010000000000000000000000111111111111110011000110000
01100111111101111000100001111110000000000000010001111111111111111110011111111100
00000111111000011101100001110011000000000000011000001111110111111110011111001100
00000111111000000111100000001110000000000000001100011111000000111111110001000000
00001111111111000111100000000111011000000001100111111110000000111111111011110000
00001101111111111111100000001111111110000000110011101111000111111111111111110000
00000111111111111111111011111111111111000000011111111111101111111111111111110000
00000111111111111111111100011111111111000000011110011001111111111111111111110000
00000000111111111111111100011111111110000000111110000001111000001111111110010000
00000000100011111121111110011100111100000000001100000001110010000011111010011000
00000000100011111111111111111111111100110000001000100001101011110111111110010000
00000000111111111111111111111111101111111000111111100001101111111111111110010000
00000000000011111111110111111111000111111111100111100001101110001100011000110000
00000000000000011110000111011001001100111110000111110001111110000000000000110000
00000000000000011100000110001111111000111110000110110001111110000010000000100000
00000000000000011000000111001111111100111110001101111001111110000111110000100000
00000000000000010000000011111111101111111111111111111011111111001100111111110000
00000000000000010000000000111000000011111001000011111111111111000000111110000000
00000000000000000000000000000000000000000001000001111111001111000000000111000000
00000000000000000000000000000000000000000000000001110011111111000000001111100000
00000000000000000000000000000000000000000000000001100011110111000110011111110000
00000000000000000000000000000000000000000000000000110011100111000100011111111000
00000000000000000000000000000000000000000000000000111111000100101100011111111000
00000000000000000000000000000000000001000000000000011100000000111000011111111110
00000000000000000000000000000000000011000000111100111000000000111000111111111110
00000000000000000000000000000000000111111001111000110001100000001101111111111110
00000000000000000000000000000000000111111111111001110011110010000111111111111110
00000000000000000000000000000000001101111111111101100011011110000111111111111110
00000000000000000000000000000000001101100110000011100100011100000011111111111000
00000000000000000000000000000000000000111100000011111100111100000001111111111000
00000000000000000000000000000000001000011111111111111111110000000001111111111000
00000000000000000000000000000010011110111111111111111111100000000111111111111100
00000000000000000000000000000010010111111111111111111111000000000000111111111100
00000000000000000000000000000011110011111111111100000011000000000000000011111100
00000000000000000000000000001001111110111111111100000001000000000000000001111110
00000000000000000000000000001011111100011111111000000000000110000001110011111110
00000000000000000000000000001111101110011111111000000000001111011111111111111110
00000000000000000000000000000110100011111111111000000000000011110000000111110010
00000000000000000000000000000000100001001100111000000000001111000000000001000010
00000000000000000000000000000000000001000000011100000000000010000000000000000010
00000000000000000000000000000000000000000000000000000000000000000000000000000000
