80 80
00000000000000000000000000000000000000000000000000000000000000000000000000000000
00000000000000000000000000000000000000000000111111000000000000000000000000000000
00000000000000000000000000000000000000000000111000000000000000000000000000000000
00000000000000000000000000000000000000000000111000000000000000000000000000000000
00000000000000000000000000000000000000001001110000000001100000000000000000000000
00000000000000000000000000000000000000001001111000000001000000000000000000000000
00000000000000000000000000000000000000001111111000000001000000000000000000000000
00000000000000000000000000000000000000011111111000000001000000000000000000000000
00000000000000000000000000000000000000111110001110000001111110000000000000000000
00000000000000000000000000000000000101111000011111100001100010000000000000000000
00000000000000000000000000000000000111011111111111110111100010000000000000000000
00000000000000000000000000000000000110001111110011111111000110000000000000000000
00000000000000000000000000000000001110000111110010111100000000000000000000000000
00000000000000000000000000000000011110000111210011100000000000000000000000000000
00000000000000000000000000000000001100001111111011100001100000000000000000000000
00000000000000000000000000000000000111111111111001110011100000000000000000000000
00000000000000000000000000000000000111111111111000110011000000000000000000000000
00000000000000000000000000000000000001100011000111111111110000000000000000000000
00000000000000000000000000000000000000000000000011111111000000000000000000000000
00000000000000000000000000000000000000000000000000110011000000000000000000000000
00000000000000000000000000000000000000000000000001100001101111101100000000000000
00000000000000000000000000000000000000000000000000100001111001111000000000000000
00000000000000000000000000000000000000000000000000100001111001100000000000000000
00000000000000000000000000000000000000000000000000110001011111000000000000000000
00000000000000000000000000000000000000000000000000110011000011000000000000000000
00000000000000000000000000000000000000000000000000100011100111100100000000000000
00000000000000000000000000000000000000000000000011100001101110111100000000000000
00000000000000000000000000000000000000000000000011000000110000011000000000000000
00000000000000000000000000000000000000000000000000000001110001000110000000000000
00000000000000000000000000000000000000000000000000000001110011100110000000000000
00000000000000000000000000000000000000000000000000000011111111100100000000000000
00000000000000000000000000000000000000000000000000000000011110111100000000000000
00000000000000000000000000000000000000000000000000000000000100011100000000000000
00000000000000000000000000000000000000000000000000000000000000110000010000000000
00000000000000000000000000000000000000000000000000000010000011111000011000000000
00000000000000000000000000000000000000000000000000000011110111111111111100000000
00000000000000000000000000000000000000000000000000000000011100000000011100000000
00000000000000000000000000000000000000000000000000000000000000000000111000000000
00000000000000000000000000000000000000000000000000000000000000000001110001001110
00000000000000000000000000000000000000000000000000000000000000000011110001111110
00000000000000000000000000000000000000000000000000000000000000000111111111111000
00000000000000000000000000000000000000000000000000000000000000011100101111110000
00000000000000000000000000000000000000000000000000000000000000011100101111100000
00000000000000000000000000000000000000000000000000000000000000011111111111000000
00000000000000000000000000000000000000000000000000000000000000111111011101100000
00000000000000000000000000000000000000000000000000000000000111111111111100111000
00000000000000000000000000000000000000000000000000000000000000011100111000001000
00000000000000000000000000000000000000000000000000000000000000001101110000000000
00000000000000000000000000000000000000000000000000000000000000000000000000000000
00000000000000000000000000000000000000000000000000000000000000000000000000000000
00000000000000000000000000000000000000000000000000000000000000000000000000000000
00000000000000000000000000000000000000000000000000000000000000000000000000000000
00000000000000000000000000000000000000000000000000000000000000000000000000000000
00000000000000000000000000000000000000000000000000000000000000000000000000000000
00000000000000000000000000000000000000000000000000000000000000000000000000000000
00000000000000000000000000000000000000000000000000000000000000000000000000000000
00000000000000000000000000000000000000000000000000000000000000000000000000000000
00000000000000000000000000000000000000000000000000000000000000000000000000000000
00000000000000000000000000000000000000000000000000000000000000000000000000000000
00000000000000000000000000000000000000000000000000000000000000000000000000000000
00000000000000000000000000000000000000000000000000000000000000000000000000000000
00000000000000000000000000000000000000000000000000000000000000000000000000000000
00000000000000000000000000000000000000000000000000000000000000000000000000000000
00000000000000000000000000000000000000000000000000000000000000000000000000000000
00000000000000000000000000000000000000000000000000000000000000000000000000000000
00000000000000000000000000000000000000000000000000000000000000000000000000000000
00000000000000000000000000000000000000000000000000000000000000000000000000000000
00000000000000000000000000000000000000000000000000000000000000000000000000000000
00000000000000000000000000000000000000000000000000000000000000000000000000000000
00000000000000000000000000000000000000000000000000000000000000000000000000000000
00000000000000000000000000000000000000000000000000000000000000000000000000000000
00000000000000000000000000000000000000000000000000000000000000000000000000000000
00000000000000000000000000000000000000000000000000000000000000000000000000000000
00000000000000000000000000000000000000000000000000000000000000000000000000000000
00000000000000000000000000000000000000000000000000000000000000000000000000000000
00000000000000000000000000000000000000000000000000000000000000000000000000000000
00000000000000000000000000000000000000000000000000000000000000000000000000000000
00000000000000000000000000000000000000000000000000000000000000000000000000000000
00000000000000000000000000000000000000000000000000000000000000000000000000000000
00000000000000000000000000000000000000000000000000000000000000000000000000000000
