80 80
00000000000000000000000000000000000000000000000000000000000000000000000000000000
00000000000000000000000000000000000000000000000000000000000000000000000000000000
00000000000000000000000000000000000000000000000000000000000000000000000000000000
00000000000000000000000000000000000000000000000000000000000000000000000000000000
00000000000000000000000000000000000000000000000000000000000000000000000000000000
00000000000000000000000000000000000000000000000000000000000000000000000000000000
00000000000000000000000000000000000000000000000000000000000000000000000000000000
00000000000000000000000000000000000000000000000000000000000000000000000000000000
00000000000000000000000000000000000000000000000000000000000000000000000000000000
00000000000000000000000000000000000000000000000000000000000000000000000000000000
00000000000000000000000000000000000000000000000000000000000000000000000000000000
00000000000000000000000000000000000000000000000000000000000000000000000000000000
00000000000000000000000000000000000000000000000000000000000000000000000000000000
00000000000000000000000000000000000000000000000000000000000000000000000000000000
00000000000000000000000000000000000000000000000000000000000000000000000000000000
00000000000000000000000000000000000000000000000000000000000000000000000000000000
00000000000000000000000000000000000000000000000000000000000000000000000000000000
00000000000000000000000000000000000000000000000000000000000000000000000000000000
00000000000000000000000000000000000000000000000000000000000000000000000000000000
00000000000000000000000000000000000000000000000000000000000000000000000000000000
00000000000000000000000000000000000000000000000000000000000000000000000000000000
00000000000000000000000000000000000000000000000000000000000000000000000000000000
00000000000000000000000000000000000000000000000000000000000000000000000000000000
00000000000000000000000000000000000000000000000000000000000000000000000000000000
00000000000000000000000000000000000000000000000000000000000000000000000000000000
00000000000000000000000000000000000000000000000000000000000000000000000000000000
00000000000000000000000000000000000000000000000000000000000000000000000000000000
00000000000000000000000000000000000000000000000000000000000000000000000000000000
00000000000000000000000000000000000000000000000000000000000000000000000000000000
00000000000000000000000000000000000000000000000000000000000000000000000000000000
00000000000000000000000000000000000000000000000000000000000000000000000000000000
00000000000000000000000000000000000000000000000000000000000000000000000000000000
00000000000000000000000000000000000000000000000000000000010000000000000000000000
00000000000000000000000000000000000000000000000000000000110000000000000000000000
00000000000000000000000000000000000000000000000000000001110000000000000000000000
00000000000000000000000000000000000000000000000000001111100000000000000000000000
00000000000000000000000000000000000000000000000000011111000000000000000000000000
00000000000000000000000000000000000000000000000000000011000000000000000000000000
00000000000000000000000000000000000000000000000000000011000000000000000000000000
00000000000000000000000000000000000000000000000000000001000001000000000000000000
00000000000000000000000000000000000000000000000000000001000111000000000000000000
00000000000000000000000000000000000000000000000000000001001100000000000000000000
00000000000000000000000000000000000000000000010000000001111000000000000000000000
00000000000000000000000000000000000000000000011100000000011000000000000000000000
00000000000000000000000000000000000000000000011110111111111000000000000000000000
00000000000000000000000000000000000000000000011111111111111110000000000000000000
00000000000000000000000000000000000000000000000011100001110110000000000000000000
00000000000000000000000000000000000000000000000010000000011110000000000000000000
00000000000000000000000000000000000000000000000010000000111110000000000000000000
00000000000000000000000000000000000000000000010010000001101110000000000000000000
00000000000000000000000000000000000000000000010011111011111110000000000000000000
00000000000000000000000000000000000000000000010000011111111111000000000000000000
00000000000000000000000000000000000000000011110000001111111110000000000000000000
00000000000000000000000000000000000000000001111000011101111110000000000000000000
00000000000000000000000000000000000000010000111001111111100110000000000000000000
00000000000000000000000000000000000000111101111001111111111111000000000000000000
00000000000000000000000000000000000001101111111000111111100000000000000000000000
00000000000000000000000000000000000001101001111100111111110000000000000000000000
00000000000000000000000000000000001111100001110110011111110000000000000000000000
00000000000000000000000000000100001111110000110011111111110011000100000000000000
00000000000000000000000011111111001111111110111111111111110110001100000000000000
00000000000000000000000110010001111111000110011111110000111110011100000000000000
00000000000000000000000000000000111111000010001111110000000111111000000000000000
00000000000000000000000000000000000111000010001111111000100001110000000000000000
00000000000000000000000001111100000111101100011111111101111101100000000000000000
00000000000000000000000011111111000111111100111111111111101111000000000000000000
00000000000000000000000001110011111100111101110011111111000000000000000000000000
00000000000000000000000110010011111000111111110111111111110000000000000000000000
00000000000000000000000011011111111000011111111111111111111111110000000000000000
00000000000000000000000011111112111100011000111000110011100011111111000000000000
00000000000000000000000001111111111110011100111111111111100111111111000000000000
00000000000000000000000011111111111111001100111111111111101110011100000000000000
00000000000000000000000001111111100001111111111111111111111100000000000000000000
00000000000000000000000000111000000000111001111101111110001100000000000000000000
00000000000000000000000001111110000100011000011001111111011110000000000000000000
00000000000000000000000111101111111110001000111001111111111110011110000000000000
00000000000000000000000000000011111111001000110000111001111011110000000000000000
00000000000000000000000000000001100001111000011000111101111111100000000000000000
00000000000000000000000000000111100011110000011111110111011111100000000000000000
00000000000000000000000000000000000000000000000000000000000000000000000000000000
