80 80
00000000000000000000000000000000000000000000000000000000000000000000000000000000
00000000000000000000000000000000000000000000000000000000000000000000000000000000
00000000000000000000000000000000000000000000000000000000000000000000000000000000
00000000000000000000000000000000000000000000000000000000000000000000000000000000
00000000000000000000000000000000000000000000000000000000000000000000000000000000
00000000000000000000000000000000000000000000000000000000000000000000000000000000
00000000000000000000000000000000000000000000000000000000000000000000000000000000
00000000000000000000000000000000000000000000000000000000000000000000000000000000
00000000000000000000000000000000000000000000000000000000000000000000000000000000
00000000000000000000000000000000000000000000000000000000000000000000000000000000
00000000000000000000000000000000000000000000000000000000000000000000000000000000
00000000000000000000000000000000000000000000000000000000000000000000000000000000
00000000000000000000000000000000000000000000000000000000000000000000000000000000
00000000000000000000000000000000000000000000000000000000000000000000000000000000
00000000000000000000000000000000000000000000000000000000000000000000000000000000
00000000000000000000000000000000000000000000000000000000000000000000000000000000
00000000000000000000000000000000000000000000000000000000000000000000000000000000
00000000000000000000000000000000000000000000000000000000000000000000000000000000
00000000000000000000000000000000000000000000000000000000000000000000000000000000
00000000000000000000000000000000000000000000000000000000000000000000000000000000
00000000000000000000000000000000000000000000000000000000000000000000000000000000
00000000000000000000000000000000000000000000000000000000000000000000000000000000
00000000000000000000000000000000000000000000000000000000000000000000000000000000
00000000000000000000000000000000000000000000000000000000000000000000000000000000
00000000000000000000000000000000000000000000000000000000000000000000000000000000
00000000000000000000000000000000000000000000000000000000000000000000000000000000
00000000000000000000000000000000000000000000000000000000000000000000000000000000
00000000000000000000000000000000000000000000000000000000000000000000000000000000
00000000000000000000000000000000000000000000000000000000000000000000000000000000
00000000000000000000000000000000000000000000000000000000000000000000000000000000
00000000000000000000000000000000000000000000000000000000000000000000000000000000
00000000000000000000000000000000000000000000000000000000000000000000000000000000
00000000000000000000000000000000000000000000000000000000000000000000000000000000
00000000000000000000000000000000000000000000000000000000000000000000000000000000
00000000000000000000000000000000000000000000000000000000000000000000000000000000
00000000000000000000000000000000000000000000000000000000000000000000000000000000
00000000000000000000000000000000000000000000000000000000000000000000000000000000
00000000000000000000000000000000000000000000000000000000000000000000000000000000
00000000000000000000000000000000000000000000000000000000000000000000000000000000
00000000000000000000000000000000000000000000000000000000000000000000000000000000
00000000000000000000000000000010000000000000000000000000000000000000000000000000
00000000000000000000000000000110000000000000000000000000000000000000000000000000
00000000000000000000000000000011000000000000000000000000000000000000000000000000
00000000000000000000000000000011100000000000000000000000000000000000000000000000
00000000000000000000000000000011111000000000000000000000000000000000000000000000
00000000000000000000000000000111111111000000000000000000000000000000000000000000
00000000000000000000000000000100110111000000000000000000000000000000000000000000
00000000000000000000000000000000110111000000000000000000000000000000000000000000
00000000000000000000100000000000100011000001000000000000000000000000000000000000
00000000000000000001100000100011100110100001111100000000000000000000000000000000
00000000000000000000100011100111111111111111111100000000000000000000000000000000
00000000000000000000110011000111100101100111111100000000000000000000000000000000
00000000000000000000110010001111100000100001100100000000000000000000000000000000
00000000000000000001111111111011100100110001000000000000000000000000000000000000
00000000000000000001111111110011100110011001011000010000000000000000000000000000
00000000000000011111111111111111001100011111110011110000000000000000000000000000
00000000000000000111110111111110001100001111110011100000000000000000000000000000
00000000000000000011111111111000011100001111000011100000000000000000000000000000
00000000000000000011111111111000111000111100000001100000000000000000000000000000
00000000000000000011100111111111101111011100110000100000000000000000000000000000
00000000000000000001111111111111111110011100010000100000000000000000000000000000
00000000000000000000111111111111111110011100011001100000000000000000000000000000
00000000000000000000001100011111111111111100001111110000000000000000000000000000
00000000000000000000001100011111211111111110001111111000000000000000000000000000
00000000000000000001111111111111111110011000011111111111000000000000000000000000
00000000000000000001111111111111111110001100111111111111100000000000000000000000
00000000000000000000111111111111111110001100111111111111000000000000000000000000
00000000000000000000001100001111111111011000111111111000000000000000000000000000
00000000000000001100001100000111111111111000111110111000000000000000000000000000
00000000001100011111011111100111111111111000111110111110000000000000000000000000
00000000001000011011111111111111111110111100111111110111000000000000000000000000
00000000011000111000001111111110001110101110011111000001100000000000000000000000
00000000011000011000001100000000001111100110000110000000000000000000000000000000
00000000001000011100001000000001110110011111000010000111100000000000000000000000
00000000001000111100111001100011111110001101100110011111110000000000000000000000
00000000011111111111110011110111111110001000111111111011100000000000000000000000
00000000000011011011100111011110011100001000000111111011000000000000000000000000
00000000000011000010000100001111111110000000000011111110000000000000000000000000
00000000000011000011000100001111001111000000000000111111000000000000000000000000
00000000000000000000000000000000000000000000000000000000000000000000000000000000
