80 80
00000000000000000000000000000000000000000000000000000000000000000000000000000000
00000000000000000000000000000000000000000000000000000000000000000000000000000000
00000000000000000000000000000000000000000000000000000000000000000000000000000000
00000000000000000000000000000000000000000000000000000000000000000000000000000000
00000000000000000000000000000000000000000000000000000000000000000000000000000000
00000000000000000000000000000000000000000000000000000000000000000000000000000000
00000000000000000000000000000000000000000000000000000000000000000000000000000000
00000000000000000000000000000000000000000000000000000000000000000000000000000000
00000000000000000000000000000000000000000000000000000000000000000000000000000000
00000000000000000000000000000000000000000000000000000000000000000000000000000000
00000000000000000000000000000000000000000000000000000000000000000000000000000000
00000000000000000000000000000000000000000000000000000000000000000000000000000000
00000000000000000000000000000000000000000000000000000000000000000000000000000000
00000000000000000000000000000000000000000000000000000000000000000000000000000000
00000000000000000000000000000000000000000000000000000000000000000000000000000000
00000000000000000000000000000000000000000000000000000000000000000000000000000000
00000000000000000000000000000000000000000000000000000000000000000000000000000000
00000000000000000000000000000000000000000000000000000000000000000000000000000000
00000000000000000000000000000000000000000000000000000000000000000000000000000000
00000000000000000000000000000000000000000000000000000000000000000000000000000000
00000000000000000000000000000000000000000000000000000000000000000000000000000000
00000000000000000000000000000000000000000000000000000000000000000000000000000000
00000000000000000000000000000000000000000000000000000000000000000000000000000000
00000000000000000000000000000000000000000000000000000000000000000000000000000000
00000000000000000000000000000000000000000000000000000000000000000000000000000000
00000000000000000000000000000000000000000000000000000000000000000000000000000000
00000000000000000000000000000000000000000000000000000000000000000000000000000000
00000000000000000000000000000000000000000000000000000000000000000000000000000000
00000000000000000000000000000000000000000000000000000000000000000000000000000000
00000000000000000000000000000000000000000000000000000000000000000000000000000000
00000000000000000000000000000000000000000000000000000000000000000000000000000000
00000000000000000000000000000000000000000000000000000000000000000000000000000000
00000000000000000000000000000000000000000000000000000000000000000000000000000000
00000000000000000000000000000000000000000000000000000000000000000000000000000000
00000000000000000000000000000000000000000000000000000000000000000000000000000000
00000000000000000000000000000000000000000000000000000000000000000000000000000000
00000000000000000000000000000000000000000000000000000000000000000000000000000000
00000010000000000000000000000000000000000000000000000000000000000000000000000000
00000011100000000000000000000000000000000000000000000000000000000000000000000000
00000111111001001000000000000000000000000000000000000000000000000000000000000000
00000111111101111000000000000000000000000000000000000000000000000000000000000000
00000111101111100000000000000000000000000000000000000000000000000000000000000000
00000111000010000000000000000000000000000000000000000000000000000000000000000000
00000111000100000000000000000000000000000000000000000000000000000000000000000000
00000111111100010000000000000000000000000000000000000000000000000000000000000000
01001111111100111100000000000000000000000000000000000000000000000000000000000000
01001111111100011100000000000000000000000000000000000000000000000000000000000000
01110001111100011111000000000000000000000000000000000000000000000000000000000000
01100001111100011100000000000000000000000000000000000000000000000000000000000000
01100111111100011001100000000000000000000000000000000000000000000000000000000000
01111111111100111011111000000000000000000000000000000000000000000000000000000000
00011100111100111111110000000000000000000000000000000000000000000000000000000000
00111000111000011110000000000000000000000000000000000000000000000000000000000000
00110111111000011111000000000000000000000000000000000000000000000000000000000000
00001111111000011100000000000000000000000000000000000000000000000000000000000000
00001111111110111000000000000000000000000000000000000000000000000000000000000000
00001111111111110000000000000000000000000000000000000000000000000000000000000000
00001111000011100000000000000000000000000000000000000000000000000000000000000000
00001111100011110000000000000000000000000000000000000000000000000000000000000000
00001111110111111100000000000000000000000000000000000000000000000000000000000000
01111111111110111100000000000000000000000000000000000000000000000000000000000000
01111110011000110000000000000000000000000000000000000000000000000000000000000000
00111110000000000000000000000000000000000000000000000000000000000000000000000000
01111100010000000000000000000000000000000000000000000000000000000000000000000000
01111111111100000000000000000000000000000000000000000000000000000000000000000000
01111111111100000000000000000000000000000000000000000000000000000000000000000000
00111111111100000000000000000000000000000000000000000000000000000000000000000000
01110111111111100000000000000000000000000000000000000000000000000000000000000000
01100011121110000000000000000000000000000000000000000000000000000000000000000000
01000111111100000000000000000000000000000000000000000000000000000000000000000000
01111111111100000000000000000000000000000000000000000000000000000000000000000000
01000110111100000000000000000000000000000000000000000000000000000000000000000000
01000001110000000000000000000000000000000000000000000000000000000000000000000000
01000000000000000000000000000000000000000000000000000000000000000000000000000000
01000000000000000000000000000000000000000000000000000000000000000000000000000000
00000000000000000000000000000000000000000000000000000000000000000000000000000000
00000000000000000000000000000000000000000000000000000000000000000000000000000000
00000000000000000000000000000000000000000000000000000000000000000000000000000000
00000000000000000000000000000000000000000000000000000000000000000000000000000000
00000000000000000000000000000000000000000000000000000000000000000000000000000000
