80 80
00000000000000000000000000000000000000000000000000000000000000000000000000000000
00000000000000000000000000000000000000001000011000000000000000000000000000000000
00000000000000000000000000000000000000001000011100000000000000000000000000000000
00000000000000000000000000000000000000011000011110000000000000000000000000000000
00000000000000000000000000000000000000111100011111100000000110000000000000000000
00000000000000000000000000000000000000111100011111110000000011011100000000000000
00000000000000000000000000000000000000111110110110110000000011111000000000000000
00010000000000000000000000000000000000111111000110011000000011110100000000000000
00110000000000000000000000000000000001111111100010001100000011100110000000000000
01100000000000000000000001100000000111111111110111111110000011000110000000000000
01111111111000000000100011100000001110111111111111110111100110000100000000000000
00111001110000000000110111110000001100011110011111111001111110000100000000000000
00110000000000000000111111111100000000011110001111111111011111001100000000000000
01100000000000000000110011001000000001011100000111100000011111111100000000000000
01100110000000001000110011001100101111011000111001110000111111111110000000000000
01101110000000011111100001000111111110011100111001110111111111211110000000000000
01111100000000100011100001100011111110001100111000111110001111111100000000000000
01111000000000100011100000100011111110000100111000111100001111111000000000000000
01110000000000111111110001100111111111000011111101111100001001100000000000000000
01111100000000111111111001100111111111111111111001111000011001000000000000000000
01111110000000111111111111100111111111111111111001110000001111000000000000000000
01100110000000111000011111000011110111111101111011110000000000000000000000000000
01000011000000110000001000000111100001111110011110110000000000000000000000000000
01000011000001111000000000111111100001111111001111000000000000000000000000000000
00000111110011111000000001100111111101111011111111100000000000000000000000000000
00000110111111111000000001100111111111011111111001110000000000000000000000000000
00001100100111110000000011000111111111001111110001110000000000000000000000000000
01001000000011110000000110000111110011111000011111100000000000000000000000000000
01111000000011000000000110001000000111110000011111000000000000000000000000000000
01001100000111100111100001111110000110011000010001111000000000000000000000000000
00001111011111111111111001001111100100011100010011110000000000000000000000000000
00000110011000000000110001000011101100000110010010000000000000000000000000000000
00000000110000000000111001100011101111000011000000000000000000000000000000000000
00000000000011000001111100000111000001000011000000000000000000000000000000000000
01111101010001110011101111000110000011111111111000000000000000000000000000000000
01111111111101111111111011100011011111111110111100000000000000000000000000000000
00110111000111111100011000000001111000011110010110000000000000000000000000000000
00100011000011001100001000000000000000000000000000000000000000000000000000000000
01100011100011001110000000000000000000000000000000000000000000000000000000000000
01000110000001001111000000000000000000000000000000000000000000000000000000000000
01000100000001111111110000000000000000000000000000000000000000000000000000000000
01001100000111100000011000000000000000000000000000000000000000000000000000000000
00011100000111000000000000000000000000000000000000000000000000000000000000000000
00011000001101100000000000000000000000000000000000000000000000000000000000000000
00011100001100100000000000000000000000000000000000000000000000000000000000000000
00001110001000000000000000000000000000000000000000000000000000000000000000000000
00000010011000000000000000000000000000000000000000000000000000000000000000000000
00000000001000000000000000000000000000000000000000000000000000000000000000000000
00000000000000000000000000000000000000000000000000000000000000000000000000000000
00000000000000000000000000000000000000000000000000000000000000000000000000000000
00000000000000000000000000000000000000000000000000000000000000000000000000000000
00000000000000000000000000000000000000000000000000000000000000000000000000000000
00000000000000000000000000000000000000000000000000000000000000000000000000000000
00000000000000000000000000000000000000000000000000000000000000000000000000000000
00000000000000000000000000000000000000000000000000000000000000000000000000000000
00000000000000000000000000000000000000000000000000000000000000000000000000000000
00000000000000000000000000000000000000000000000000000000000000000000000000000000
00000000000000000000000000000000000000000000000000000000000000000000000000000000
00000000000000000000000000000000000000000000000000000000000000000000000000000000
00000000000000000000000000000000000000000000000000000000000000000000000000000000
00000000000000000000000000000000000000000000000000000000000000000000000000000000
00000000000000000000000000000000000000000000000000000000000000000000000000000000
00000000000000000000000000000000000000000000000000000000000000000000000000000000
00000000000000000000000000000000000000000000000000000000000000000000000000000000
00000000000000000000000000000000000000000000000000000000000000000000000000000000
00000000000000000000000000000000000000000000000000000000000000000000000000000000
00000000000000000000000000000000000000000000000000000000000000000000000000000000
00000000000000000000000000000000000000000000000000000000000000000000000000000000
00000000000000000000000000000000000000000000000000000000000000000000000000000000
00000000000000000000000000000000000000000000000000000000000000000000000000000000
00000000000000000000000000000000000000000000000000000000000000000000000000000000
00000000000000000000000000000000000000000000000000000000000000000000000000000000
00000000000000000000000000000000000000000000000000000000000000000000000000000000
00000000000000000000000000000000000000000000000000000000000000000000000000000000
00000000000000000000000000000000000000000000000000000000000000000000000000000000
00000000000000000000000000000000000000000000000000000000000000000000000000000000
00000000000000000000000000000000000000000000000000000000000000000000000000000000
00000000000000000000000000000000000000000000000000000000000000000000000000000000
00000000000000000000000000000000000000000000000000000000000000000000000000000000
00000000000000000000000000000000000000000000000000000000000000000000000000000000
