80 80
00000000000000000000000000000000000000000000000000000000000000000000000000000000
00000000000000000000000000000000000000000000000000000000000000000000000000000000
00000000000000000000000000000000000000000000000000000000000000000000000000000000
00000000000000000000000000000000000000000000000000000000000000000000000000000000
00000000000000000000000000000000000000000000000000000000000000000000000000000000
00000000000000000000000000000000000000000000000000000000000000000000000000000000
00000000000000000000000000000000000000000000000000000000000000000000000000000000
00000000000000000000000000000000000000000000000000000000000000000000000000000000
00000000000000000000000000000000000000000000000000000000000000000000000000000000
00000000000000000000000000000000000000000000000000000000000000000000000000000000
00000000000000000000000000000000000000000000000000000000000000000000000000000000
00000000000000000000000000000000000000000000000000000000000000000000000000000000
00000000000000000000000000000000000000000000000000000000000000000000000000000000
00000000000000000000000000000000000000000000000000000000000000000000000000000000
00000000000000000000000000000000000000000000000000000000000000000000000000000000
00000000000000000000000000000000000000000000000000000000000000000000000000000000
00000000000000000000000000000000000000000000000000000000000000000000000000000000
00000000000000000000000000000000000000000000000000000000000000000000000000000000
00000000000000000000000000000000000000000000000000000000000000000000000000000000
00000000000000000000000000000000000000000000000000000000000000000000000000000000
00000000000000000000000000000000000000000000000000000000000000000000000000000000
00000000000000000000000000000000000000000000000000000000000000000000000000000000
00000000000000000000000000000000000000000000000000000000000000000000000000000000
00000000000000000000000000000000000000000000000000000000000000000000000000000000
00000000000000000000000000000000000000000000000000000000000000000000000000000000
00000000000000000000000000000000000000000000000000000000000000000000000000000000
00000000000000000000000000000000000000000000000000000000000000000000000000000000
00000000000000000000000000000000000000000000000000000000000000000000000000000000
00000000000000000000000000000000000000000000000000000000000000000000000000000000
00000000000000000000000000000000000000000000000000000000000000000000000000000000
00000000000000000000000000000000000000000000000000000000000000000000000000000000
00000000000000000000000000000000000000000000000000000000000000000000000000000000
00000000000000000000000000000000000000000000000000000000000000000000000000000000
00000000000000000000000000000000000000000000000000000000000000000000000000000000
00000000000000000000000000000000000000000000000000000000000000000000000000000000
00000000000000000000000000000000000000000000000000000000000000000000000000000000
00000000000000000000000000000000000000000000000000000000000000000000000000000000
00000000000000000000000000000000000000000000000000000000000000000000000000000000
00000000000000000000000000000000000000000000000000000000000000000000000000000000
00000000000000000000000000000000000000000000000000000000000000000000000000000000
00000000000000000000000000000000000000000000000000000000000000000000000000000000
00000000000000000000000000000000000000000000000000000000000000000000000000000000
00000000000000000000000000000000000000000000000000000000000000000000000000000000
00000000000000000000000000000000000000000000000000000000000000000000000000000000
00000000000000000000000000000000000000000000000000000011100000000000000000000000
00000000000000000000000000000000000000000000000000000011100000000000000000000000
00000000000000000000000000000000000000000000000000000111100000000000000000000000
00000000000000000000000000000000000000000000000000000011100000000000000000000000
00000000000000000000100000000000000000000000000000000001110000000000000000000000
00000000000000000000110000000000000000001001100000100001100000000000000000000000
00000000000000000001110000000000000000001000111111110001000000000000000000000000
00000000000000000001100000000000000010011000001111111111001000000000000000000000
00000000000000000011000000000000000111110000001111111110001000000000000000000000
00000000100000000010000000000000011110000000011111110011001000000000000000000000
00000111111011110110110000000000000110001000011111100001111100010000000000000000
00001111111111111111100000000000000100011100111111110011111111110000000000000000
00001101101110111111100000000000001100111000111111110111011011100000000000000000
00011111000111111000000000000000001111100001111111111110001111000000000000000000
01000111000111110000000010000000001111110001111111111110001111000000000000000000
01000110011111111000111111001111111111111001111111110111001110000000000000000000
01000110111111111111111111111111111110011111111111110011111111000000000000000000
01001111111111111111101111111111111100001111111111111001111111000000000000000000
01100111000111111100000111111111111000000111111111111111111111000010000000000000
01111100000111111100000011111111110000000111111110111111111110000011000000000000
01111100001111111111100011111111111110011111111111111111111110000110000000000000
01111100001111111111111111111211111111111111111111111111100111000100000000000000
00100110011001111111111111111111111111111111111111111111100011101100110000000000
00000011110001111100001111111111111001111111111111111111110001111111110000000000
00000011100001110000001111111111111101111100111111111111110011101000011100000000
00000011100001111000111011111111001111111100111111111111111011001100011100000000
00000111111111111111110011101111101111111100111111111111111111001110011100000000
00000101100111111111110011000011111111111100111111111111111110000010001100000000
00011111000011111110011111000000111101111111111111111111111110100000000000000000
00000111000000111100111111110000011100111110011111111111111111100000000000000000
00000011000000011001111111111111111110011100011111111111111111110001000000000000
00001111111100111001110111111111111110011100111111111111111111111111000000000000
00001000000111100001110111100111111111111111110111111111111110110000000000000000
00000000000110000001100001100011100011111111100011111111000000100000000000000000
00000000000110000001100000100011110000111111100011111110000001100000000000000000
00000000000000000000000000000000000000000000000000000000000000000000000000000000
