80 80
00000000000000000000000000000000000000000000000000000000000000000000000000000000
00000000000000000000000000000000000000000000000000000000000000000000000000000000
00000000000000000000000000000000000000000000000000000000000000000000000000000000
00000000000000000000000000000000000000000000000000000000000000000000000000000000
00000000000000000000000000000000000000000000000000000000000000000000000000000000
00000000000000000000000000000000000000000000000000000000000000000000000000000000
00000000000000000000000000000000000000000000000000000000000000000000000000000000
00000000000000000000000000000000000000000000000000000000000000000000000000000000
00000000000000000000000000000000000000000000000000000000000000000000000000000000
00000000000000000000000000000000000000000000000000000000000000000000000000000000
00000000000000000000000000000000000000000000000000000000000000000000000000000000
00000000000000000000000000000000000000000000000000000000000000000000000000000000
00000000000000000000000000000000000000000000000000000000000000000000000000000000
00000000000000000000000000000000000000000000000000000000000000000000000000000000
00000000000000000000000000000000000000000000000000000000000000000000000000000000
00000000000000000000000000000000000000000000000000000000000000000000000000000000
00000000000000000000000000000000000000000000000000000000000000000000000000000000
00000000000000000000000000000000000000000000000000000000000000000000000000000000
00000000000000000000000000000000000000000000000000000000000000000000000000000000
00000000000000000000000000000000000000000000000000000010000000000000000000000000
00000000000000000000000000000000000000000000000000100111000000000000000000000000
00000000000000000000000000000000000000000000000000111111100000000000000000000000
00000000000000000000000000000000000000000000000000011111100000000000000000000000
00000000000000000000000000000000000000000000000000111110000000000000000000000000
00000000000000000000000000000000000000000000000000111111000000000000000000000000
00000000000000000000000000000000000000000000000001111111000000000000000000000000
00000000000000000000000000000000000000000000000001101001100000000000000000000000
00000000000000000000000000000000000000000000000011000001100000000000000000000000
00000000000000000000000000000000000000000000001110000100000000000000000000000000
00000000000000000000000000000000000000000000011011000100000000000000000000000000
00000000000000000000000000000000000000000000010111111100000000000000000000000000
00000000000000000000000000000000000000000000110110111000000000000000000000000000
00000000000000000000000000000000000000000000000011111000000000000000000000000000
00000000000000000000000000000000000000000000000001111000000000000000000000000000
00000000000000000000000000000000000000000011111000111000000000000000000000000000
00000000000000000000000000000000000000111111111111110000000000000000000000000000
00000000000000000000000000000000000000000001111111100000000000000000000000000000
00000000000000000000000000000000000000000001111211100000000000000000000000000000
00000000000000000000000000000000000000000001111111100000000000000000000000000000
00000000000000000000000000000000000000000001111111110000000000000000000000000000
00000000000000000000000000000000000000000000111111110000000000000000000000000000
00000000000000000000000000000000000000000000111111110000000000000000000000000000
00000000000000000000000000000000000000000000011111110000000000000000000000000000
00000000000000000000000000000000000000000000011111111111100000000000000000000000
00000000000000000000000000000000000000000000111101110011100000000000000000000000
00000000000000000000000000000000000000001110111111111111000000000000000000000000
00000000000000000000000000000000000000000011111011100111000000000000000000000000
00000000000000000000000000000000000000000001100011000111100000000000000000000000
00000000000000000000000000000000000000000011000011000011000000000000000000000000
00000000000000000000000000000000000000001111100111110111100000000000000000000000
00000000000000000000000000000000000000001000111101110111110000000000000000000000
00000000000000000000000000000000000000011000001100100111110000000000000000000000
00000000000000000000000000000000000000111100000000100000000000000000000000000000
00000000000000000000000000000000000000111000000000000000000000000000000000000000
00000000000000000000000000000000000001111000000000000000000000000000000000000000
00000000000000000000000000000000000101111000000000000000000000000000000000000000
00000000000000000000000000000000000111001100000000000000000000000000000000000000
00000000000000000000000000000000000111000100000000000000000000000000000000000000
00000000000000000000000000000000000110001100000000000000000000000000000000000000
00000000000000000000000000011010000110001100000000000000000000000000000000000000
00000000000000000000000101011111001110011100000000000000000000000000000000000000
00000000000000000000000111001111111100011000000000000000000000000000000000000000
00000000000000000000000010000000111000000000000000000000000000000000000000000000
00000000000000000000000010000000110000000000000000000000000000000000000000000000
00000000000000000000000011000011111110000000000000000000000000000000000000000000
00000000000000000000000111000111001110000000000000000000000000000000000000000000
00000000000000000000001101111110001000000000000000000000000000000000000000000000
00000000000000000000000101111111110000000000000000000000000000000000000000000000
00000000000000000000000111001111110000000000000000000000000000000000000000000000
00000000000000000000000011001110000000000000000000000000000000000000000000000000
00000000000000000000000001000010000000000000000000000000000000000000000000000000
00000000000000000000000000000000000000000000000000000000000000000000000000000000
00000000000000000000000000000000000000000000000000000000000000000000000000000000
00000000000000000000000000000000000000000000000000000000000000000000000000000000
00000000000000000000000000000000000000000000000000000000000000000000000000000000
00000000000000000000000000000000000000000000000000000000000000000000000000000000
00000000000000000000000000000000000000000000000000000000000000000000000000000000
00000000000000000000000000000000000000000000000000000000000000000000000000000000
00000000000000000000000000000000000000000000000000000000000000000000000000000000
00000000000000000000000000000000000000000000000000000000000000000000000000000000
