80 80
00000000000000000000000000000000000000000000000000000000000000000000000000000000
00000000000000000000000000000000000000000000000000000000000000000000000000000000
00000000000000000000000000000000000000000000000000000000000000000000000000000000
00000000000000000000000000000000000000000000000000000000000000000000000000000000
00000000000000000000000000000000000000000000000000000000000000000000000000000000
00000000000000000000000000000000000000000000000000000000000000000000000000000000
00000000000000000000000000000000000000000000000000000000000000000000000000000000
00000000000000000000000000000000000000000000000000000000000000000000000000000000
00000000000000000000000000000000000000000000000000000000000000000000000000000000
00000000000000000000000000000000000000000000000000000000000000000000000000000000
00000000000000000000000000000000000000000000000000000000000000000000000000000000
00000000000000000000000000000000000000000000000000000000000000000000000000000000
00000000000000000000000000000000000000000000000000000000000000000000000000000000
00000000000000000000000000000000000000000000000000000000000000000000000000000000
00000000000000000000000000000000000000000000000000000000000000000000000000000000
00000000000000000000000000000000000000000000000000000000000000000000000000000000
00000000000000000000000000000000000000000000000000000000000000000000000000000000
00000000000000000000000000000000000000000000000000000000000000000000000000000000
00000000000000000000000000000000000000000000000000000000000000000000000000000000
00000000000000000000000000000000000000000000000000000000000000000000011100000000
00000000000000000000000000000000000000000000000000000000000000000000011110000000
00000000000000000000000000000000000000000000000000000000000100000010011100000000
00000000000000000000000000000000000000000000000000000000000100000010011100000000
00000000000000000000000000000000000000000000000000000000000111000011111000000000
00000000000000000000000000000000000000000000000000000000000111000111111000000000
00000000000000000000000000000000000000000000000000000000000111100111111101111010
00000000000000000000000000000000000000000000000000000000000111101101101111111110
00000000000000000000000000000000000000000000000000000000000111100000000111111100
00000000000000000000000000000000000000000000000000000000000111100000000111111000
00000000000000000000000000000000000000000000000000000001111111110010001111110000
00000000000000000000000000000000000000000000011000000111111111111111011101111000
00000000000000000000000000000000000000000000001000000001111111011111111001001110
00000000000000000000000000000000000000000000001100000000111111101110001100000000
00000000000000000000000000000000000000000000011110000001111111111100001111000000
00000000000000000000000000000000000000000000011011000111111111111100001101100000
00000000000000000000000000000000000000000000010001111111111111111110011100000000
00000000000000000000000000000000000000000000110000011111111111111111011000001000
00000000000000000000000000000000000000000000100000001111111111111111111000001000
00000000000000000000000000000000000000000000000000000011121111001111111100001100
00000000000000000000000000000000000000000000000000000011111111000110011111011100
00000000000000000000000000000000000000000000000000000011111111000100011111111100
00000000000000000000000000000000000000000000000000000011110000001100001111111100
00000000000000000000000000000000000000000000000000000111100000011000001111100000
00000000000000000000000000000000000000000000000000000011110000011000001110000000
00000000000000000000000000000000000000000000000000000011111000111100001000000000
00000000000000000000000000000000000000000000000000000011111111111110001000000000
00000000000000000000000000000000000000000000000000000111111111001110001000000000
00000000000000000000000000000000000000000000000000000111110011111100011000000000
00000000000000000000000000000000000000000000000010001101111011000000010000000000
00000000000000000000000000000000000000000000000010111001111110000000000000000000
00000000000000000000000000000000000000000000000111110011111111000000000000000000
00000000000000000000000000000000000000000000001111100011000010000000000000000000
00000000000000000000000000000000000000000000000011100111100001000000000000000000
00000000000000000000000000000000000000000000000000111001100001110000000000000000
00000000000000000000000000000000000000000000001000110011000011111000000000000000
00000000000000000000000000000000000000000000111100100111100011110100000000000000
00000000000000000000000000000000000000000000111111100111110111110110000000000000
00000000000000000000000000000000000000000000111111000111110111110110000000000000
00000000000000000000000000000000000000000000010001000011111111111100000000000000
00000000000000000000000000000000000000000000010001100011100111011100000000000000
00000000000000000000000000000000000000000000010000100011110111010100111000000000
00000000000000000000000000000000000000000000010000110011111110000111100000000000
00000000000000000000000000000000000000000000000000011101111000000110000000000000
00000000000000000000000000000000000000000000000000001110110000000000000000000000
00000000000000000000000000000000000000000000000000000101110000001100000000000000
00000000000000000000000000000000000000000000000000000011111111000101111000000000
00000000000000000000000000000000000000000000000000000001001000000111000000000000
00000000000000000000000000000000000000000000000000000000001000001111000000000000
00000000000000000000000000000000000000000000000000000000001000011111000000000000
00000000000000000000000000000000000000000000000000000000001100111111100000000000
00000000000000000000000000000000000000000000000000000000000111111110111100000000
00000000000000000000000000000000000000000000000000000000000011011100010000000000
00000000000000000000000000000000000000000000000000000000000000011000000000000000
00000000000000000000000000000000000000000000000000000000000000011000001111100000
00000000000000000000000000000000000000000000000000000000000110001100011111100000
00000000000000000000000000000000000000000000000000000000001111001110011100110000
00000000000000000000000000000000000000000000000000000000000011100111111110000000
00000000000000000000000000000000000000000000000000000000000001100111110010000000
00000000000000000000000000000000000000000000000000000000000001111111110000000000
00000000000000000000000000000000000000000000000000000000000000000000000000000000
