80 80
00000000000000000000000000000000000000000000000000000000000000000000000000000000
01111100000000000000000000000000000000000000000000000000000000000000000000000000
01111100000000000000000000000000000000000000000000000000000000000000000000000000
01111000000000000000000000000000000000000000000000000000000000000000000000000000
01111100000000000000000000000000000000000000000000000000000000000000000000000000
01111110000000000000000000000000000000000000000000000000000000000000000000000000
01110110000000000000000000000000000000000000000000000000000000000000000000000000
01110001000000000000000000000000000000000000000000000000000000000000000000000000
01110001100000000000000000000000000000000000000000000000000000000000000000000000
01111111111000000000000000000000000000000000000000000000000000000000000000000000
01111111111000000000000000000000000000000000000000000000000000000000000000000000
01011111101100000000000000000000000000000000000000000000000000000000000000000000
00011011111000000000000000000000000000000000000000000000000000000000000000000000
00111001110000000000000000000000000000000000000000000000000000000000000000000000
01111110110000000000000000000000000000000000000000000000000000000000000000000000
01011111111110000000000000000000000000000000000000000000000000000000000000000000
01101111100000000000000000000000000000000000000000000000000000000000000000000000
01111101100000000000000000000000000000000000000000000000000000000000000000000000
01111001111000000000000000000000000000000000000000000000000000000000000000000000
01001111111000000000000000000000000000000000000000000000000000000000000000000000
01001110011000000000000000000000000000000000000000000000000000000000000000000000
01101100111000000000000000000000000000000000000000000000000000000000000000000000
01111100001100000000000000000000000000000000000000000000000000000000000000000000
01111001001111011000000000000000000000000000000000000000000000000000000000000000
01111111001111011000000000000000000000000000000000000000000000000000000000000000
01111111011111110000000000000000000000000000000000000000000000000000000000000000
00001000111001110000000000000000000000000000000000000000000000000000000000000000
00000000011000000000000000000000000000000000000000000000000000000000000000000000
01100000011110000000000000000000000000000000000000000000000000000000000000000000
01111101111111110000000000000000000000000000000000000000000000000000000000000000
01111111111111111000000000000000000000000000000000000000000000000000000000000000
00111111111111111100000000000000000000000000000000000000000000000000000000000000
00110011100001110100001000000000000000000000000000000000000000000000000000000000
00101111110000111100001100000000000000000000000000000000000000000000000000000000
00001111111000111100011110000000000000000000000000000000000000001000000000000000
00001110011100111111111111000000000000000000000000000000000000001110000000000000
00001110001100111111001101100000000000000000000000000000000000000111000000000000
00001111001111001000000000000000000000000000000000000000000000101111000000000000
00011111111111000000000000000000000000000000000000000000000001111111001000000000
00111111111111111000110000000000000000000000000000000000000011000111111000000000
01111111111111111111110000000000000000000000000000000000000010001111111100000000
01111111111111110111100000000000000000000000000000000000000110001111101100000000
01111101111100000000000000000000000000000000000000000000000100011011000000000000
00111101111000000000000000011100000000000000000000000000000100011111000010000000
01111111111101110001001001111110001000000111110000000000000110111110000110000000
01111111111111111111111011111111001111111111111000000011100111111110111110000000
01111111111111111111111111011011000011110000110000000001100011111111111100000000
01110000111111111110000110001001000000000000100000000011000011100111100000000000
01111001111111111111000010001001000000000000100000000111111110000111110000000000
01111111111111111111110011011111110000011100110000000001100110001111111100000000
01111111111111111111110011111111111111111100111000000011100111001111111100000000
01101111111111111111111011111111111111111100001100000011000011111111111110000000
01100011111111111111111111111111111111111100000110000011000111111111111100000000
01111111111111111111111111111111111100111110000110000011111111001111111100000000
01111111111111111111111111111111111100111110001111100011111111001110111111111000
01111111111111111111111111111111111111111111111111110011111111001111111111111110
01111111111111111111111111111111001111111111110110110011111111001111111111111110
01111111111111111111111111111111100000000111111100001111011011101111000000000110
01111111111111111111111111111111111000000011111000010011011001101111100000000010
01111111111111111111111111111111111110011111111000110011111011101111111111110000
01111111111111111111111111111111111111111111111001110001111111001111111111111100
01111111111111111111111111111111111111111111111111100001111110000111111000111110
01111111111111111111111111111111111111100011111111100000111110000011110001111110
01111111111111111111111111111111111111000011110111110000110111110001111011111110
01111111111111111111111111111111111111111111111111110001110011111100111111011110
01111111111111111111111111111111111111111111111111110011100111001111111111111010
01111111111111111111111111111111111111111111111111110111000110000111111111110010
01111111111111111111111111111111111111110011111111101100001100000011101111110110
01111111111111111111111111111111111111111111111111101100111100000011000000011110
01111111111111111111111111111111111111111111111111111111100010000110000000011110
01111111111111111111111111111111111111111111111111111111100111001110000000111000
01011111111111111111111111111111111111111100111111111111001100001110000000110000
00001111111111111111111111111111111111110001111111110111111000000000010000111000
01011111111111111111111111111111111110000111111111100001111000100001111000110000
01111111111111111111111111111111111110011111111001100001111001100011111000111000
01111111111111111111111111111111111111111111111100100011111111000000111101111000
01111121111111111111111111111111111111111111111100110011000000000000101111001100
01111111111111111111111111111111111111111111000100011110000000000000000010000110
01111111111111111111111111111111111111111100001100010110000000000000000000000010
00000000000000000000000000000000000000000000000000000000000000000000000000000000
