80 80
00000000000000000000000000000000000000000000000000000000000000000000000000000000
00000000000000000001000000001100011110000000000000000111100110000110011000000000
00000000000000000001000000001000001110000000000000011111000110000111011000000000
00000000000000000001111000001000000111000000000000001111111110000001111000100000
00000000000000110011111100001100000111100000011001111111111111011111111000111000
00000000000000111001110000000111100111111100111011111111111111111111111100111000
00000000000000011101110000000001111100001010011110011111111111111111001110111000
00000000000000001111100000000000111000000110001100000000111110111111000111011000
00000111000111111111100010000001110000001100001110000000111100111111000011001100
00000111101100111111110011100011110011001100011111100011100111111111110111011110
00000111111000111111110011110011011111011100111001110011111111111111111111111110
00000111111000111101111111111110011000111101110000111011111111001111111111110110
00000111111100111111111111111100000000111111100001111111111000000101111011100110
00000111111111110001110000111000000000011111100011111111111000000100111111111110
01001111111111110001110001111111011110011111110111111111111110001100111110011000
01111111111111111001110011100111101110011111111111111111100111001111111110110000
01111112111111111111110011000111001111111111111111111111100011100111111001110000
01111111111111111111100011000111111111101110011110111111100001100111000001110000
01111111111111111000111111111111111110001110011111111011100001100111111100100000
01111110011111111000111111111111101110011100111111110011100011101110011100110000
01111110011111111001111111111111101110011100111111111011100111001110011100111010
01111110011111111001100111111111111100011100111001111111101110001110001100001110
01111111111111111111100011111001111100011100111111001111101110001111000100000000
00001111111111111111000011100011111100111111111111001111101111111100000000000000
00001110111111111111100011000011001111111111111111111111101111111100000000000000
01101110011111111111110011100011001111111111111111111111111111111110000000000000
01111110011111111101111001100011000111111111111111111111111111110110000000000000
00111000011111111100011000100001001111111000000111111111111111110000000000000000
00011000011101111100110000110000111100110000000011111111100111111100000000000000
01111100011101111111110001110000111101111111111001111111000111111100000000000000
01111110011111111111110011101111111111111111111001111111100111111110000000000000
01111110001111111111100011111001000011001111111001111111100111111100000000000000
00111110000111111000000001110000000000000011111111111111111100111100000000000000
00011111110000110000000000000000111000000011111111111111110000001100000000000000
00111111111000110000000000000000001100011110111001111111110011000110000100000000
01111111111100010000000000000000001110011100111001111111111111111111111110000000
01111111111100110000000000000000000111111100110001111111001110001100110000000000
00111111111111110000000000000000000011100000111000111110001110000000110000000000
01101111111111000000000000000000000001000000011000000110000111000000011000000000
01000111111110000000000000000000000011000000010000100011100111000000001100000000
01000110111110000000000000000000001110000000010001111111100111000000011000000000
01001100011000000000000000000000001000000000010001111111100110000000000000000000
01110000000000000000000000000000000000000000000000011101111100000000000000000000
01110000000000000000000000000000000000000001010110110000011100000000000000000000
00000000000000000000000000000000000000001011110111100000010110000000000000000000
00000000000000000000000000000000000000001111111111110000000111000000000000000000
00000000000000000000000000000000000000001011011110011100000011100000000000000000
00000000000000000000000000000000000000000110001110001100000000110000000000000000
00000000000000000000000000000000000000000100001111101100110000010000000000000000
00000000000000000000000000000000000000000000011111111100110000011000000000000000
00000000000000000000000000000000000000000000010001100111100000001110000000000000
00000000000000000000000000000000000000000000000001100000000000000000000000000000
00000000000000000000000000000000000000000000000000000000000000000000000000000000
00000000000000000000000000000000000000000000000000000000000000000000000000000000
00000000000000000000000000000000000000000000000000000000000000000000000000000000
00000000000000000000000000000000000000000000000000000000000000000000000000000000
00000000000000000000000000000000000000000000000000000000000000000000000000000000
00000000000000000000000000000000000000000000000000000000000000000000000000000000
00000000000000000000000000000000000000000000000000000000000000000000000000000000
00000000000000000000000000000000000000000000000000000000000000000000000000000000
00000000000000000000000000000000000000000000000000000000000000000000000000000000
00000000000000000000000000000000000000000000000000000000000000000000000000000000
00000000000000000000000000000000000000000000000000000000000000000000000000000000
00000000000000000000000000000000000000000000000000000000000000000000000000000000
00000000000000000000000000000000000000000000000000000000000000000000000000000000
00000000000000000000000000000000000000000000000000000000000000000000000000000000
00000000000000000000000000000000000000000000000000000000000000000000000000000000
00000000000000000000000000000000000000000000000000000000000000000000000000000000
00000000000000000000000000000000000000000000000000000000000000000000000000000000
00000000000000000000000000000000000000000000000000000000000000000000000000000000
00000000000000000000000000000000000000000000000000000000000000000000000000000000
00000000000000000000000000000000000000000000000000000000000000000000000000000000
00000000000000000000000000000000000000000000000000000000000000000000000000000000
00000000000000000000000000000000000000000000000000000000000000000000000000000000
00000000000000000000000000000000000000000000000000000000000000000000000000000000
00000000000000000000000000000000000000000000000000000000000000000000000000000000
00000000000000000000000000000000000000000000000000000000000000000000000000000000
00000000000000000000000000000000000000000000000000000000000000000000000000000000
00000000000000000000000000000000000000000000000000000000000000000000000000000000
00000000000000000000000000000000000000000000000000000000000000000000000000000000
