80 80
00000000000000000000000000000000000000000000000000000000000000000000000000000000
00000000000000000000000000000000000000000000000000000000000000000000000000000000
00000000000000000000000000000000000000000000000000000000000000000000000000000000
00000000000000000000000000000000000000000000000011000110000000000000000000000000
00000000000000000000000000000000000000000000000111100111111100000000000000000000
00000000000000000000000000000000000000000000111100100111111111111110000000000000
00000000000000000000000000000000000000000000100100111111110001110000000000000000
00000000000000000000000000000000000000000000000110011111110000000000000000000000
00000000000000000000000000000000000000000000000010011111110000000000000000000000
00000000000000000000000000000000000000000000110011111111111111111110000000000000
00000000000000000000000000000000000000000000010001111111111111111110000000000000
00000000000000000000000000000000000000000000011001111111211111111110000000000000
00000000000000000000000000000000000000000000001111111111111111111100000000000000
00000000000000000000000000000000000000000000000000111111111100001100000000000000
00000000000000000000000000000000000000000101110011111111111110001100000000000000
00000000000000000000000000000000000000001111111111111011100111101100000000000000
00000000000000000000000000000000000000001011011111110011100011100110000000000000
00000000000000000000000000000000000000000110011100111111111111100011000000000000
00000000000000000000000000000000000000001100011001111111111111100001110000000000
00000000000000000000000000000000000000001000111111110111001111111000001000000000
00000000000000000000000000000000000000001000111101110011111111111111001000000000
00000000000000000000000000000000000000001000011100110001111111110111011000000000
00000000000000000000000000000000000000001000011111110001111111100111111000000000
00000000000000000000000000000000000000001000011111111111111111111111100000000000
00000000000000000000000000000000000000001000011001111111111111111100000000000000
00000000000000000000000000000000000000001000010001111111111111111111000000000000
00000000000000000000000000000000000000000000110001011111111111000100000000000000
00000000000000000000000000000000000000000000000000001100011111100000000000000000
00000000000000000000000000000000000000000000000001000100001111110000000000000000
00000000000000000000000000000000000000000000000001100110111111111100000000000000
00000000000000000000000000000000000000000000000001110111111111111110000000000000
00000000000000000000000000000000000000000000000000110011111111111110000000000000
00000000000000000000000000000000000000000000000000111001111111111110000000000000
00000000000000000000000000000000000000000000000000011111111111111100001000000000
00000000000000000000000000000000000000000000000000111111111111111101111100000000
00000000000000000000000000000000000000000000000001111111111111111111111100000000
00000000000000000000000000000000000000000000000001100001111111100011111100000000
00000000000000000000000000000000000000000000000000001111111111100000000110000000
00000000000000000000000000000000000000000000000000011011111111100011000010000000
00000000000000000000000000000000000000000000000000000001101111111111110110000000
00000000000000000000000000000000000000000000000000000001100111111110111100000000
00000000000000000000000000000000000000000000000000000011000111111110001000000000
00000000000000000000000000000000000000000000000000000011000011111110001000000000
00000000000000000000000000000000000000000000000000000001100011111111111110000000
00000000000000000000000000000000000000000000000000000001100011111111111100000000
00000000000000000000000000000000000000000000000000000011100111111110111110000000
00000000000000000000000000000000000000000000000000000011000111111110011110000000
00000000000000000000000000000000000000000000000000000011111111111111000111000000
00000000000000000000000000000000000000000000000000000011100011111111001111100000
00000000000000000000000000000000000000000000000000000011000011111111111110110000
00000000000000000000000000000000000000000000000000000011100111111111111110010000
00000000000000000000000000000000000000000000000000000001100110111111111110011000
00000000000000000000000000000000000000000000000000000011100110001111111000011000
00000000000000000000000000000000000000000000000000000011100010000111111000111100
00000000000000000000000000000000000000000000000000000001000011000110011000111100
00000000000000000000000000000000000000000000000000000111100010001110011100111110
00000000000000000000000000000000000000000000000000000011000010001100001100111110
00000000000000000000000000000000000000000000000000000000000011001100000011100110
00000000000000000000000000000000000000000000000000000000000001101110000001000010
00000000000000000000000000000000000000000000000000000011100011101110000000100110
00000000000000000000000000000000000000000000000000000011100111001111111111111100
00000000000000000000000000000000000000000000000000000011111110011100100000000100
00000000000000000000000000000000000000000000000000000111111110011000100000000000
00000000000000000000000000000000000000000000000000000011011111000000000000000000
00000000000000000000000000000000000000000000000000000011011111000100010000000000
00000000000000000000000000000000000000000000000000000001111111111111011100000000
00000000000000000000000000000000000000000000000000000001111110001111001100000000
00000000000000000000000000000000000000000000000000000000111100001111000110000000
00000000000000000000000000000000000000000000000000000000011100001110000111000000
00000000000000000000000000000000000000000000000000100111011111001100001111100000
00000000000000000000000000000000000000000000000000100011111111001110011110111000
00000000000000000000000000000000000000000000000000100001111110000111111100000000
00000000000000000000000000000000000000000000000000100001111110000000111100001000
00000000000000000000000000000000000000000000000001111000100110010000011001111110
00000000000000000000000000000000000000000000000001100101100111111100011001110000
00000000000000000000000000000000000000000000000001111111111111111110001111111000
00000000000000000000000000000000000000000000000000111111111111110110001111110000
00000000000000000000000000000000000000000000000000111110011111111110000011100000
00000000000000000000000000000000000000000000000000111111011111111111000110110000
00000000000000000000000000000000000000000000000000000000000000000000000000000000
