80 80
00000000000000000000000000000000000000000000000000000000000000000000000000000000
00000000000000000000000000000000000000000000000000000000000000000000000000000000
00000000000000000000000000000000000000000000000000000000000000000000000000000000
00000000000000000000000000000000000000000000000000000000000000000000000000000000
00000000000000000000000000000000000000000000000000000000000000000000000000000000
00000000000000000000000000000000000000000000000000000000000000000000000000011000
00000000000000000000000000000000000000000000000000000000000000000000000000011100
00000000000000000000000000000100000000000000000000000000000000010000000000001100
00000000000000000000000000011100000000000000000000000000000000010000000010001000
00000000000000110000000001111110001100011111110000000000000000110100000010011000
00000000000000010011110011111111111111111111111001100000000011111100111110111000
00000000000000011110010111011111000011111001111111000000000011100111110000110000
00000000000000111110000110001001000000000001100010000010000011000111100000110000
01000000100011111110000010001011100000001001110010000111001110000111100000110010
01111000100111011111100011011111110111111101110011000001100110000111111100111010
01101111111111111111110011111111111111111100111011110011100111001111111100111010
00000011110000110111110001111111111111111100001111110011000011111110011110111110
00000000000001100011110001111112111111111100000110000011000111111111111100001110
00000000000001100011111111111111111111111110000110000011111111001111111100000110
00000000000000110011111111111111111100111110001111100001111110001110011111111110
00000000000000011011111111111111111111111111111111110011111111001110111111111110
00000000000000011111111011111111000111111111110110010011111011000111101111111110
00000000000000001111101001111110000000000111111100000010011011001111000000000110
00000000000000000000001001100011110000000001111000010010011001101111100001000010
00000000000000000001111001110011111100000011111000110011011011001111111111111010
00000000000000000001111111111111111111111111111001100001111111001111111111111110
00000000000000000000111111111111111111100011111111100001111110000111111000111110
00000000000000000000000111000100111111000001100111100000011000000011110001111110
00000000000000000000000011000000011111000001100111100000010011110001111111111110
00000000000000000000000001000011111111000111110011110000110011111100111111111110
00000000000000000000000001100111011111011111111111110011100010001111111111111110
00000000000000000000000001000000000000111011011111100110000110000111111111110110
00000000000000000000000111000000000000000001110011000100001100000011111111111110
00000000000000000000000000000000000000000001110011000100011000000011110000111110
00000000000000000000000000000000000000000000110111101101100000000111111000111110
00000000000000000000000000000000000000000000111100101111000000001111011100111110
00000000000000000000000000000000000000000000001000111111000000001110001100111000
00000000000000000000000000000000000000000000000000000001000000000000011101111000
00000000000000000000000000000000000000000000000000000001110000100011111101111110
00000000000000000000000000000000000000000000000000000001111001100111111111111110
00000000000000000000000000000000000000000000000000000001001111000111111111111110
00000000000000000000000000000000000000000000000000000000000000001100111111111110
00000000000000000000000000000000000000000000000000000000000000001100100111111110
00000000000000000000000000000000000000000000000000000000000000000100000011111110
00000000000000000000000000000000000000000000000000000000000000000100101111111110
00000000000000000000000000000000000000000000000000000000000000000100111111111110
00000000000000000000000000000000000000000000000000000000000000000100111011111100
00000000000000000000000000000000000000000000000000000000000000000000000011111100
00000000000000000000000000000000000000000000000000000000000000000000001111100100
00000000000000000000000000000000000000000000000000000000000000000000011111110100
00000000000000000000000000000000000000000000000000000000000000000000001111111110
00000000000000000000000000000000000000000000000000000000000000000000001110011100
00000000000000000000000000000000000000000000000000000000000000000000000000000000
00000000000000000000000000000000000000000000000000000000000000000000000000000000
00000000000000000000000000000000000000000000000000000000000000000000000000000000
00000000000000000000000000000000000000000000000000000000000000000000000000000000
00000000000000000000000000000000000000000000000000000000000000000000000000000000
00000000000000000000000000000000000000000000000000000000000000000000000000000000
00000000000000000000000000000000000000000000000000000000000000000000000000000000
00000000000000000000000000000000000000000000000000000000000000000000000000000000
00000000000000000000000000000000000000000000000000000000000000000000000000000000
00000000000000000000000000000000000000000000000000000000000000000000000000000000
00000000000000000000000000000000000000000000000000000000000000000000000000000000
00000000000000000000000000000000000000000000000000000000000000000000000000000000
00000000000000000000000000000000000000000000000000000000000000000000000000000000
00000000000000000000000000000000000000000000000000000000000000000000000000000000
00000000000000000000000000000000000000000000000000000000000000000000000000000000
00000000000000000000000000000000000000000000000000000000000000000000000000000000
00000000000000000000000000000000000000000000000000000000000000000000000000000000
00000000000000000000000000000000000000000000000000000000000000000000000000000000
00000000000000000000000000000000000000000000000000000000000000000000000000000000
00000000000000000000000000000000000000000000000000000000000000000000000000000000
00000000000000000000000000000000000000000000000000000000000000000000000000000000
00000000000000000000000000000000000000000000000000000000000000000000000000000000
00000000000000000000000000000000000000000000000000000000000000000000000000000000
00000000000000000000000000000000000000000000000000000000000000000000000000000000
00000000000000000000000000000000000000000000000000000000000000000000000000000000
00000000000000000000000000000000000000000000000000000000000000000000000000000000
00000000000000000000000000000000000000000000000000000000000000000000000000000000
00000000000000000000000000000000000000000000000000000000000000000000000000000000
