80 80
00000000000000000000000000000000000000000000000000000000000000000000000000000000
00000000000000000000000000000000000000000000000000000000000000000000000000000000
00000000000000000000000000000000000000000000000000000000000000000000000000000000
00000000000000000000000000000000000000000000000000000000000000000000000000000000
00000000000000000000000000000000000000000000000000000000000000000000000000000000
00000000000000000000000000000000000000000000000000000000000000000000000000000000
00000000000000000000000000000000000000000000000000000000000000000000000000000000
00000000000000000000000000000000000000000000000000000000000000000000000000000000
00000000000000000000000000000000000000000000000000000000000000000000000000000000
00000000000000000000000000000000000100000000000000000000000000000000000000000000
00000000000000000000000000000000000110001010000000000000000000000000000000000000
00000000000000000000000000000000000111001110000000000000000000000000000000000000
00000000000000000000000000000000000101111110000000000000000000000000000000000000
00000000000000000000000000000000111100111100000000000000000000000000000000000000
00000000000000000000000000000000111100011001110000000000000000000000000000000000
00000000000000000000000001100000011100001110110000000000000000000000000000000000
00000000000000000000000001000000000110001111110000000000000000000000000000000000
00000000000000000000000001110000100010001001000000000000000000000000000000000000
00000000000000000000000011111101110010011000000110000000000000100000010000000000
00000000000000000000001111000111101110011000010011000000000011111101111000000000
00000000000000000000000111111111111110011000011001110000000111001111111000000000
00000000000000000000000000000110011100001100010000110000000110000111001000000000
00000000000000000000000000000000010000011100110000110000011110000011111100000000
00000000000000000000000000000000010000111111110001110000011111000011111100000000
00000000000000000000000011001110011111111111111011101111011011000110011110000000
00000000000000000000000001011111111111111110111001111111111110000100011111111100
00000000000000000000000001111011111110111110111000111001111110001100011000100000
00000000000000000000000001111011100001111010011111111000011100001100000000000000
00000000000000000000000001111111000011000010011111111000111110001100000000000000
00000000000000000000000001110110000110001111111121111101110110001100000000000000
00000000000000000000000011100010001110011111111111111111100110001110000000000000
00000000000000000000000000000010000100111001111100111111000110000010000000000000
00000000000000000000000000000111000111100001000000011000000000000000000000000000
00000000000000000000000000000111100110000001001111100000000000000000000000000000
00000000000000000000000000000011100100000001111111100000000000000000000000000000
00000000000000000000000000000010000100111111111101100000000000000000000000000000
00000000000000000000000000000010000110100101111100110000000000000000000000000000
00000000000000000000000000000000000000111100011000000000000000000000000000000000
00000000000000000000000000000000000000011100000000000000000000000000000000000000
00000000000000000000000000000000000000000000000000000000000000000000000000000000
00000000000000000000000000000000000000000000000000000000000000000000000000000000
00000000000000000000000000000000000000000000000000000000000000000000000000000000
00000000000000000000000000000000000000000000000000000000000000000000000000000000
00000000000000000000000000000000000000000000000000000000000000000000000000000000
00000000000000000000000000000000000000000000000000000000000000000000000000000000
00000000000000000000000000000000000000000000000000000000000000000000000000000000
00000000000000000000000000000000000000000000000000000000000000000000000000000000
00000000000000000000000000000000000000000000000000000000000000000000000000000000
00000000000000000000000000000000000000000000000000000000000000000000000000000000
00000000000000000000000000000000000000000000000000000000000000000000000000000000
00000000000000000000000000000000000000000000000000000000000000000000000000000000
00000000000000000000000000000000000000000000000000000000000000000000000000000000
00000000000000000000000000000000000000000000000000000000000000000000000000000000
00000000000000000000000000000000000000000000000000000000000000000000000000000000
00000000000000000000000000000000000000000000000000000000000000000000000000000000
00000000000000000000000000000000000000000000000000000000000000000000000000000000
00000000000000000000000000000000000000000000000000000000000000000000000000000000
00000000000000000000000000000000000000000000000000000000000000000000000000000000
00000000000000000000000000000000000000000000000000000000000000000000000000000000
00000000000000000000000000000000000000000000000000000000000000000000000000000000
00000000000000000000000000000000000000000000000000000000000000000000000000000000
00000000000000000000000000000000000000000000000000000000000000000000000000000000
00000000000000000000000000000000000000000000000000000000000000000000000000000000
00000000000000000000000000000000000000000000000000000000000000000000000000000000
00000000000000000000000000000000000000000000000000000000000000000000000000000000
00000000000000000000000000000000000000000000000000000000000000000000000000000000
00000000000000000000000000000000000000000000000000000000000000000000000000000000
00000000000000000000000000000000000000000000000000000000000000000000000000000000
00000000000000000000000000000000000000000000000000000000000000000000000000000000
00000000000000000000000000000000000000000000000000000000000000000000000000000000
00000000000000000000000000000000000000000000000000000000000000000000000000000000
00000000000000000000000000000000000000000000000000000000000000000000000000000000
00000000000000000000000000000000000000000000000000000000000000000000000000000000
00000000000000000000000000000000000000000000000000000000000000000000000000000000
00000000000000000000000000000000000000000000000000000000000000000000000000000000
00000000000000000000000000000000000000000000000000000000000000000000000000000000
00000000000000000000000000000000000000000000000000000000000000000000000000000000
00000000000000000000000000000000000000000000000000000000000000000000000000000000
00000000000000000000000000000000000000000000000000000000000000000000000000000000
00000000000000000000000000000000000000000000000000000000000000000000000000000000
