80 80
00000000000000000000000000000000000000000000000000000000000000000000000000000000
00000000000000000000000011000000001100000000000000001111001111001100000000000000
00000000000000000000000011000000111111110000001000000111001111011000000000000000
00000000000000000000000001110000011111110000001100000111001100110001100000000000
00000000000000000000000001111110001111111010011100100111111110110111110000000000
00000000000000000000000001111010001111011111111111110011110111111110011000010000
00000000000000000000000000011011001111001111100111000011110011111100001100010000
00000000000000000000000000001111001111000011000000000111110011110000000100110000
00000000000000000000000000001111111111100011000111000111111111100000000000011100
00000000000000000000000000001111101100011111111001101111111111100111000000010110
00000000000000000000000000001111101110011111111001111111111111101110111100111100
00000000000000000000000000001111100110001111110000111111001111111100110000111110
00000000000000000000000000000111100000000001100000011110001111111111100000100110
00000000000000000000000000000111100000110001111110001100011111111111110000100010
00000000000000000000000000001111111100111001111111111111111111211111111000010010
00000000000000000000000001111111111111111111111111111111111111111111111000010010
00000000000000000000000001111111111111111111111100111111100111111101111000011110
00000000000000000000000111111111100001111111111100011111111011110000111100011110
00000000000000000000000111110001100001111111111100011111111111110000011111100110
00000000000000000000110001111111111111111111111000111111101111111110111000110110
00000000000000000000110011111111111111111111111001110011100111111111111100011010
00000000000000000000110011011111111111111111111011110001110111111111101100011110
00000000000000000000011110011000111111000001110011100001111111111111111100000110
00000000000000000000000000110001111111100001110001100111111111111111111100000110
00000000000000000000000001100011111111111111110001111111100111001111111101111110
00000000000000000001110001000111001111111111111001111111100111101111111110111110
00000000000000000000011111000110000111111110011000111111100111001111111110011100
00000000000000000000001100001100000001111110011000111111111110001111000010000000
00000000000000000000011000001000000000111100111101111111111110000110000010000000
00000000000000000010010000011011111100111000111111111111111110011100000111110000
00000000000000000011110001111111111111011101111111111111110111111111111100010000
00000000000000000000000000001110000010001111111111111111110011111111110000010000
00000000000000000000000000001000000000000111100011110000000011110000000000000000
00000000000000000000000000000000000000000110000011110000000011011000000000000000
00000000000000000000000000000000000000001100000011111111000110001100000000000000
00000000000000000000000000000000000000011101111111111111100110000100000000000000
00000000000000000000000000000000000000111001000011111101100011000110000000000000
00000000000000000000000000000000000000000000000001111000100010000010010000000000
00000000000000000000000000000000000000000000000001111000100010011000110000000000
00000000000000000000000000000000000000000000000001111001100011111100111000000000
00000000000000000000000000000000000000000000000000111111000011110101101000000000
00000000000000000000000000000000000000000000000001100111000110100111101000000000
00000000000000000000000000000000000000000000000000000100000111100111000000000000
00000000000000000000000000000000000000000000000000000000000111000011100000000000
00000000000000000000000000000000000000000000000000000000111110000111111000000000
00000000000000000000000000000000000000000000000000000011101111000100001100000000
00000000000000000000000000000000000000000000000000000111000011111000001000000000
00000000000000000000000000000000000000000000000000000010000000110000000000000000
00000000000000000000000000000000000000000000000000000000000000000000000000000000
00000000000000000000000000000000000000000000000000000000000000000000000000000000
00000000000000000000000000000000000000000000000000000000000000000000000000000000
00000000000000000000000000000000000000000000000000000000000000000000000000000000
00000000000000000000000000000000000000000000000000000000000000000000000000000000
00000000000000000000000000000000000000000000000000000000000000000000000000000000
00000000000000000000000000000000000000000000000000000000000000000000000000000000
00000000000000000000000000000000000000000000000000000000000000000000000000000000
00000000000000000000000000000000000000000000000000000000000000000000000000000000
00000000000000000000000000000000000000000000000000000000000000000000000000000000
00000000000000000000000000000000000000000000000000000000000000000000000000000000
00000000000000000000000000000000000000000000000000000000000000000000000000000000
00000000000000000000000000000000000000000000000000000000000000000000000000000000
00000000000000000000000000000000000000000000000000000000000000000000000000000000
00000000000000000000000000000000000000000000000000000000000000000000000000000000
00000000000000000000000000000000000000000000000000000000000000000000000000000000
00000000000000000000000000000000000000000000000000000000000000000000000000000000
00000000000000000000000000000000000000000000000000000000000000000000000000000000
00000000000000000000000000000000000000000000000000000000000000000000000000000000
00000000000000000000000000000000000000000000000000000000000000000000000000000000
00000000000000000000000000000000000000000000000000000000000000000000000000000000
00000000000000000000000000000000000000000000000000000000000000000000000000000000
00000000000000000000000000000000000000000000000000000000000000000000000000000000
00000000000000000000000000000000000000000000000000000000000000000000000000000000
00000000000000000000000000000000000000000000000000000000000000000000000000000000
00000000000000000000000000000000000000000000000000000000000000000000000000000000
00000000000000000000000000000000000000000000000000000000000000000000000000000000
00000000000000000000000000000000000000000000000000000000000000000000000000000000
00000000000000000000000000000000000000000000000000000000000000000000000000000000
00000000000000000000000000000000000000000000000000000000000000000000000000000000
00000000000000000000000000000000000000000000000000000000000000000000000000000000
00000000000000000000000000000000000000000000000000000000000000000000000000000000
