80 80
00000000000000000000000000000000000000000000000000000000000000000000000000000000
00000000000000000000000000000000000000000011110001111111000011111100000000000000
00000000000000000000000000000000000000000001111011000111000111110000000000000000
00000000000000000000000000000000000000000000011111100011011111100000000000000000
00000000000000000000000000000000000000000000011111100011111111110100000000000000
00000000000000000000000000000000000000000000010011110011111111111100000000000000
00000000000000000000000000000000000000000000110001110011111110110000000000000000
00000000000000000000000000000000000000000000000000000011111111100000000000000000
00000000000000000000000000000000000000000000000100000111111111100000000000000000
00000000000000000000000000000000000000000001000111111111111111000000000000000000
00000000000000000000000000000000000000001111111111111111111110000000000000000000
00000000000000000000000000000000000000000000001111111011111110000000000000000000
00000000000000000000000000000000000000000000011111110001100110000000000000000000
00000000000000000000000000000000000000000001111111110011000110000000000000000000
00000000000000000000000000000000000000000000011101111111100110000100000000000000
00000000000000000000000000000000000000000001111101111111100111000100000000000000
00000000000000000000000000000000000000000001101101111111100111000111000000000000
00000000000000000000000000000000000000000001100011111111000111111110000000000000
00000000000000000000000000000000000000000000110011111110011111001110000000000000
00000000000000000000000000000000000000000000010111110111111110001100000000000000
00000000000000000000000000000000000000000000011111110111110110000100011100000000
00000000000000000000000000000000000000000000011111110011000011000110110000000000
00000000000000000000000000000000000000000000111111111000000001000001100000000000
00000000000000000000000000000000000000011111110011111100000001110001000000000000
00000000000000000000000000000000000000111111110001111111111111110011000000000000
00000000000000000000000000000000000000011111111001111111111111111111000000000000
00000000000000000000000000000000000000011011111001111111111111101100000000000000
00000000000000000000000000000000000000000001111001111000011111001110000000000000
00000000000000000000000000000000000000000000011111111100011111101110000000000000
00000000000000000000000000000000000000000001111111111111111111101100000000000000
00000000000000000000000000000000000000001111111001111111111111001110000000000000
00000000000000000000000000000000000000000000010000111111111111001110000000000000
00000000000000000000000000000000000000000000000000111111111110000010000000000000
00000000000000000000000000000000000000000000001110011111111111011100000000000000
00000000000000000000000000000000000000000000011011111111121111111110000000000000
00000000000000000000000000000000000000000000010011111111111111111110111100000000
00000000000000000000000000000000000000000000011001111111111111111111100000000000
00000000000000000000000000000000000000000000001100000111111111000110000000000000
00000000000000000000000000000000000000000000000100001111111110000100000000000000
00000000000000000000000000000000000000000001110011111111111110000100000000000000
00000000000000000000000000000000000000000000111011111111111111000100000000000000
00000000000000000000000000000000000000000000011111111111100011001100000000000000
00000000000000000000000000000000000000000000000010001100000001101100000000000000
00000000000000000000000000000000000000000000000011001100000001101100000000000000
00000000000000000000000000000000000000000000000001111111100011000100000000000000
00000000000000000000000000000000000000000000000001111111110110000100000000000000
00000000000000000000000000000000000000000000000000111111001110000000000000000000
00000000000000000000000000000000000000000000000000110000000000000000000000000000
00000000000000000000000000000000000000000000000001100000000000000000000000000000
00000000000000000000000000000000000000000000000001100110000000000000000000000000
00000000000000000000000000000000000000000000000000111111100000000000000000000000
00000000000000000000000000000000000000000000000000011000100000000000000000000000
00000000000000000000000000000000000000000000000000000000000000000000000000000000
00000000000000000000000000000000000000000000000000000000000000000000000000000000
00000000000000000000000000000000000000000000000000000000000000000000000000000000
00000000000000000000000000000000000000000000000000000000000000000000000000000000
00000000000000000000000000000000000000000000000000000000000000000000000000000000
00000000000000000000000000000000000000000000000000000000000000000000000000000000
00000000000000000000000000000000000000000000000000000000000000000000000000000000
00000000000000000000000000000000000000000000000000000000000000000000000000000000
00000000000000000000000000000000000000000000000000000000000000000000000000000000
00000000000000000000000000000000000000000000000000000000000000000000000000000000
00000000000000000000000000000000000000000000000000000000000000000000000000000000
00000000000000000000000000000000000000000000000000000000000000000000000000000000
00000000000000000000000000000000000000000000000000000000000000000000000000000000
00000000000000000000000000000000000000000000000000000000000000000000000000000000
00000000000000000000000000000000000000000000000000000000000000000000000000000000
00000000000000000000000000000000000000000000000000000000000000000000000000000000
00000000000000000000000000000000000000000000000000000000000000000000000000000000
00000000000000000000000000000000000000000000000000000000000000000000000000000000
00000000000000000000000000000000000000000000000000000000000000000000000000000000
00000000000000000000000000000000000000000000000000000000000000000000000000000000
00000000000000000000000000000000000000000000000000000000000000000000000000000000
00000000000000000000000000000000000000000000000000000000000000000000000000000000
00000000000000000000000000000000000000000000000000000000000000000000000000000000
00000000000000000000000000000000000000000000000000000000000000000000000000000000
00000000000000000000000000000000000000000000000000000000000000000000000000000000
00000000000000000000000000000000000000000000000000000000000000000000000000000000
00000000000000000000000000000000000000000000000000000000000000000000000000000000
00000000000000000000000000000000000000000000000000000000000000000000000000000000
