80 80
00000000000000000000000000000000000000000000000000000000000000000000000000000000
00000000000000000000110011011110111111110000000000000000000000000000000000000000
00000000000000000000011110011100010001110000000000000000000000000000000000000000
00000000000000000000011111111100010000110000000000000000000000000000000000000000
00000000000000000000111111100110011000111001100000000000000000000000000000000000
00000000011100000001111111100011001111111111111000000000000000000000000000000000
00000000000110000000111111100011000111011110000000000000000000000000000000000000
00000011000011000000001111100001100011000111000000000000000000000000000000000000
00000001100111100000000111010001110111000000000000000000000000000000000000000000
00011011111111110000100111111111111111111000000000000000000000000000000000000000
01011111111111110000110011111111111111111100000000000000000000000000000000000000
01111111111111011001110001111111111111100100000000000000000000000000000000000000
01111111111111001111110001111111111111000001000000000000000000000000000000000000
01111111111000000111111111111111211111100001100000000000000000000000000000000000
01111111111100000011111111111111111111110011110000000000000000000000000000000000
01111110011100000011111111111111111110111110111001110000000000000000000000000000
01111100011000000000000111111111111110001100111001100000000000000000000000000000
01111000001111100000000011111111000111000000111111100000000000000000000000000000
01111000000001011100000111111111000111100011111111110000010000000000000000000000
01101100111000111111001111001111000111111111110011111000111110000000000000000000
01001111111000111011111111100111001111111111111001111111101111111110000000000000
01000110001100111001111101110011111000111110011000011111000111110000000000000000
01000100000110111000011100010000000000111110001100001111111111100000000000000000
01100110000011111000111111010000000000110000111100001111111111000000000000000000
00100100000011111000111111000000000001111000011110111111111111000000000000000000
01100100000001111000100001000000000000001000111011110011111111101100000000000000
01000000000000111000100000000000000000000000111001100001111111111100000000000000
00000000000000011000000000000000000000000011111011100000111111111110000000000000
00000000000000011000000000000000000000000000111111100000011111111111000000000000
00000000000000011000000000000000000000000000011111110000011111111111001111011110
00000000000000111000000000000000000000000000111011110001111111111111011111111110
00000000000000110000000000000000000000000001110001100000001111111111111111111000
00000000000000000000000000000000000000000001100000000000001111111111111111110000
00000000000000000000000000000000000000000000000000000000000111111111111111110010
00000000000000000000000000000000000000000000000000000000000111001111111100111110
00000000000000000000000000000000000000000000000000000000000111001110111100111110
00000000000000000000000000000000000000000000000000000000000110000100111100111110
00000000000000000000000000000000000000000000000000000000001110000000111101111110
00000000000000000000000000000000000000000000000000000000011100000000000111111110
00000000000000000000000000000000000000000000000000000000111111100000000111111110
00000000000000000000000000000000000000000000000000000011111111000100001101111110
00000000000000000000000000000000000000000000000000000001111111001100000000111000
00000000000000000000000000000000000000000000000000000000111100001100000000110000
00000000000000000000000000000000000000000000000000000000111100001110000000110000
00000000000000000000000000000000000000000000000000000000111111101100000000011110
00000000000000000000000000000000000000000000000000000011111111111100000000011110
00000000000000000000000000000000000000000000000000000000000011110000000000010100
00000000000000000000000000000000000000000000000000000000000000100000000000000110
00000000000000000000000000000000000000000000000000000000000000000000000000000010
00000000000000000000000000000000000000000000000000000000000000000000000000000000
00000000000000000000000000000000000000000000000000000000000000000000000000000000
00000000000000000000000000000000000000000000000000000000000000000000000000000000
00000000000000000000000000000000000000000000000000000000000000000000000000000000
00000000000000000000000000000000000000000000000000000000000000000000000000000000
00000000000000000000000000000000000000000000000000000000000000000000000000000000
00000000000000000000000000000000000000000000000000000000000000000000000000000000
00000000000000000000000000000000000000000000000000000000000000000000000000000000
00000000000000000000000000000000000000000000000000000000000000000000000000000000
00000000000000000000000000000000000000000000000000000000000000000000000000000000
00000000000000000000000000000000000000000000000000000000000000000000000000000000
00000000000000000000000000000000000000000000000000000000000000000000000000000000
00000000000000000000000000000000000000000000000000000000000000000000000000000000
00000000000000000000000000000000000000000000000000000000000000000000000000000000
00000000000000000000000000000000000000000000000000000000000000000000000000000000
00000000000000000000000000000000000000000000000000000000000000000000000000000000
00000000000000000000000000000000000000000000000000000000000000000000000000000000
00000000000000000000000000000000000000000000000000000000000000000000000000000000
00000000000000000000000000000000000000000000000000000000000000000000000000000000
00000000000000000000000000000000000000000000000000000000000000000000000000000000
00000000000000000000000000000000000000000000000000000000000000000000000000000000
00000000000000000000000000000000000000000000000000000000000000000000000000000000
00000000000000000000000000000000000000000000000000000000000000000000000000000000
00000000000000000000000000000000000000000000000000000000000000000000000000000000
00000000000000000000000000000000000000000000000000000000000000000000000000000000
00000000000000000000000000000000000000000000000000000000000000000000000000000000
00000000000000000000000000000000000000000000000000000000000000000000000000000000
00000000000000000000000000000000000000000000000000000000000000000000000000000000
00000000000000000000000000000000000000000000000000000000000000000000000000000000
00000000000000000000000000000000000000000000000000000000000000000000000000000000
00000000000000000000000000000000000000000000000000000000000000000000000000000000
