80 80
00000000000000000000000000000000000000000000000000000000000000000000000000000000
00000000000000000000000000000011100100000000000000000000000000000000000000000000
00000000000000000000000000000001100100000000000000000000000000000000000000000000
00000000000000000000000000000001111100000000000000000000000000000000000000000000
00000000000000000000000000000011001100000000000000000000000000000000000000000000
00000000000000000000000000000010000100000000000000000000000000000000000000000000
00000000000000000000000000000110000100000000000000000000000000000000000000000000
00000000000000000000001000001100000000000000000000000000000000000000000000000000
00000000000000000000001000001100000000000000000000000000000000000000000000000000
00000000000000000000001100011110000000000000000000000000000000000000000000000000
00000000000000000000000111111111000000000000000000000000000000000000000000000000
00000000000000000000000000011011011000000000000000000000000000000000000000000000
00000000000000000000000000001001110000000000000000000000000000000000000000000000
00000000000000000000000000011111000000000000000000000000000000000000000000000000
00000000000000000000000000111111000010000000000000000000000000000000000000000000
00000000000000000001111111110111001110000000000000000000000000000000000000000000
00000000000000000000001111000111111000000000000000000000000000000000000000000000
00000000000000000000000010000011110000000000000000000000000000000000000000000000
00000000000000000000000000110111110000000000000000000000000000000000000000000000
00000000000000000000000001111111110010001000000000000000000000000000000000000000
00000000000000000000000011111111111110001000000000000000000000000000000000000000
00000000000000000000001110011111111100001000000000000000000000000000000000000000
00000000000000000000000100001112111000001100000000000000000000000000000000000000
00000000000000000000000000011111111110000100000000000000000000000000000000000000
00000000000000000000000001111111111111101111000111100000000000000000000000000000
00000000000000000000000011100111111111111111111100100000000000000000000000000000
00000000000000000000000010000011100111110011000000110000000000000000000000000000
00000000000000000000000000000000000011000010000000011000000000000000000000000000
00000000000000000000000000000000000011000110000000001000001000000000000000000000
00000000000000000000000000000000000111111110011111101110011000000000000000000000
00000000000000000000000000000000000100111110111001111111110000000100000000000000
00000000000000000000000000000000000000011001110000111101110000000100000000000000
00000000000000000000000000000000000000000001100000011100010000000100000000000000
00000000000000000000000000000000000000000011111111101100000000001100000000000000
00000000000000000000000000000000000000000111111001111111111100011100000000000000
00000000000000000000000000000000000000001111111001111111111111111110000000000000
00000000000000000000000000000000000000000000011101100111110001111110000000000000
00000000000000000000000000000000000000000000001111000011110000011111100000000000
00000000000000000000000000000000000000000000001111000001100000001001000000000000
00000000000000000000000000000000000000000000011111100001100000001111000000000000
00000000000000000000000000000000000000000000010001110011111111111110000000000000
00000000000000000000000000000000000000000000010000011011111011111110000000000000
00000000000000000000000000000000000000000000000000010001111011100000000000000000
00000000000000000000000000000000000000000000000000000001111111100000000000000000
00000000000000000000000000000000000000000000000000000001111111100000000000000000
00000000000000000000000000000000000000000000000000000011111111100000000000000000
00000000000000000000000000000000000000000000000000000011001100000000000000000000
00000000000000000000000000000000000000000000000000000000011000000000000000000000
00000000000000000000000000000000000000000000000000000000001100000000000000000000
00000000000000000000000000000000000000000000000000000000000110000000000000000000
00000000000000000000000000000000000000000000000000000000000010000000000000000000
00000000000000000000000000000000000000000000000000000000000000000000000000000000
00000000000000000000000000000000000000000000000000000000000000000000000000000000
00000000000000000000000000000000000000000000000000000000000000000000000000000000
00000000000000000000000000000000000000000000000000000000000000000000000000000000
00000000000000000000000000000000000000000000000000000000000000000000000000000000
00000000000000000000000000000000000000000000000000000000000000000000000000000000
00000000000000000000000000000000000000000000000000000000000000000000000000000000
00000000000000000000000000000000000000000000000000000000000000000000000000000000
00000000000000000000000000000000000000000000000000000000000000000000000000000000
00000000000000000000000000000000000000000000000000000000000000000000000000000000
00000000000000000000000000000000000000000000000000000000000000000000000000000000
00000000000000000000000000000000000000000000000000000000000000000000000000000000
00000000000000000000000000000000000000000000000000000000000000000000000000000000
00000000000000000000000000000000000000000000000000000000000000000000000000000000
00000000000000000000000000000000000000000000000000000000000000000000000000000000
00000000000000000000000000000000000000000000000000000000000000000000000000000000
00000000000000000000000000000000000000000000000000000000000000000000000000000000
00000000000000000000000000000000000000000000000000000000000000000000000000000000
00000000000000000000000000000000000000000000000000000000000000000000000000000000
00000000000000000000000000000000000000000000000000000000000000000000000000000000
00000000000000000000000000000000000000000000000000000000000000000000000000000000
00000000000000000000000000000000000000000000000000000000000000000000000000000000
00000000000000000000000000000000000000000000000000000000000000000000000000000000
00000000000000000000000000000000000000000000000000000000000000000000000000000000
00000000000000000000000000000000000000000000000000000000000000000000000000000000
00000000000000000000000000000000000000000000000000000000000000000000000000000000
00000000000000000000000000000000000000000000000000000000000000000000000000000000
00000000000000000000000000000000000000000000000000000000000000000000000000000000
00000000000000000000000000000000000000000000000000000000000000000000000000000000
