80 80
00000000000000000000000000000000000000000000000000000000000000000000000000000000
00000000000000000000000000000000000000000000000000100000000111001110000000000000
00000000000000000000000000000000000000000000000000100000000011111111100000000000
00000000000000000000000000000000000000000000100011100000000000111111000000000000
00000000000000000000000000000000000000000000111111111111001111111110000000000000
00000000000000000000000000000000000000000000111111111111111111111110000000000000
00000000000000000000000000000000000000000000011111111001111011111111000000000000
00000000000000000000000000000000000000000010000111000000000000100111000000000000
00000000000000000000000000000000000000000010000011000000000001111111000000000000
00000000000000000000000000000000000001100110000001101111000011111111100000000000
00000000000000000000000000000000000000111111111101111111110111111111111100000000
00000000000000000000000000000000000000000001000110111111111111111101000110000000
00000000000000000000000000000000000000000001000110000000110111110000000000000000
00000000000000000000000000000000000000000001000010000000010011100000000000000000
00000000000000000000000000000000000000000000100011101111111011110000000000000000
00000000000000000000000000000000000000000000111001111111111111111100000000000000
00000000000000000000000000000000000000000000011100111111111110000000000000000000
00000000000000000000000000000000000000000000000110011111111100000000000000000000
00000000000000000000000000000000000000000000000111100111111110000000000000000000
00000000000000000000000000000000000000000000001111111111101110000000000000000000
00000000000000000000000000000000000000000000111111111111101110000000000000000000
00000000000000000000000000000000000000000001111111111111100000000000000000000000
00000000000000000000000000000000000000000000011111112111100000000000000000000000
00000000000000000000000000000000000000000000111111111111100000000000000000000000
00000000000000000000000000000000000000110000111101111111100000000000000000000000
00000000000000000000000000000000000000011101111101111111100000000000000000000000
00000000000000000000000000000000000000000111111111100111000000000000000000000000
00000000000000000000000000000000000000000011111100100010000000000000000000000000
00000000000000000000000000000000000000000000111000100000000000000000000000000000
00000000000000000000000000000000000011110000011001100001000000000000000000000000
00000000000000000000000000000000000000011110111001110001110000000000000000000000
00000000000000000000000000000000000000000111110000110011010000000000000000000000
00000000000000000000000000000000000000000010010000011000110000000000000000000000
00000000000000000000000000000000000000000010011100000001100000000000000000000000
00000000000000000000000000000000000000000110011111100001000000000000000000000000
00000000000000000000000000000000000000001101111101100001000000000000000000000000
00000000000000000000000000000000000000000001100100110001000000000000000000000000
00000000000000000000000000000000000000000000000100011011100000000000000000000000
00000000000000000000000000000000000000000000000100011111000000000000000000000000
00000000000000000000000000000000000000000000000100111111000000000000000000000000
00000000000000000000000000000000000000000000000000101111000000000000000000000000
00000000000000000000000000000000000000000000000001100100000000000000000000000000
00000000000000000000000000000000000000000000000011000100000000000000000000000000
00000000000000000000000000000000000000000000000000000100000000000000000000000000
00000000000000000000000000000000000000000000000000000000000000000000000000000000
00000000000000000000000000000000000000000000000000000000000000000000000000000000
00000000000000000000000000000000000000000000000000000000000000000000000000000000
00000000000000000000000000000000000000000000000000000000000000000000000000000000
00000000000000000000000000000000000000000000000000000000000000000000000000000000
00000000000000000000000000000000000000000000000000000000000000000000000000000000
00000000000000000000000000000000000000000000000000000000000000000000000000000000
00000000000000000000000000000000000000000000000000000000000000000000000000000000
00000000000000000000000000000000000000000000000000000000000000000000000000000000
00000000000000000000000000000000000000000000000000000000000000000000000000000000
00000000000000000000000000000000000000000000000000000000000000000000000000000000
00000000000000000000000000000000000000000000000000000000000000000000000000000000
00000000000000000000000000000000000000000000000000000000000000000000000000000000
00000000000000000000000000000000000000000000000000000000000000000000000000000000
00000000000000000000000000000000000000000000000000000000000000000000000000000000
00000000000000000000000000000000000000000000000000000000000000000000000000000000
00000000000000000000000000000000000000000000000000000000000000000000000000000000
00000000000000000000000000000000000000000000000000000000000000000000000000000000
00000000000000000000000000000000000000000000000000000000000000000000000000000000
00000000000000000000000000000000000000000000000000000000000000000000000000000000
00000000000000000000000000000000000000000000000000000000000000000000000000000000
00000000000000000000000000000000000000000000000000000000000000000000000000000000
00000000000000000000000000000000000000000000000000000000000000000000000000000000
00000000000000000000000000000000000000000000000000000000000000000000000000000000
00000000000000000000000000000000000000000000000000000000000000000000000000000000
00000000000000000000000000000000000000000000000000000000000000000000000000000000
00000000000000000000000000000000000000000000000000000000000000000000000000000000
00000000000000000000000000000000000000000000000000000000000000000000000000000000
00000000000000000000000000000000000000000000000000000000000000000000000000000000
00000000000000000000000000000000000000000000000000000000000000000000000000000000
00000000000000000000000000000000000000000000000000000000000000000000000000000000
00000000000000000000000000000000000000000000000000000000000000000000000000000000
00000000000000000000000000000000000000000000000000000000000000000000000000000000
00000000000000000000000000000000000000000000000000000000000000000000000000000000
00000000000000000000000000000000000000000000000000000000000000000000000000000000
00000000000000000000000000000000000000000000000000000000000000000000000000000000
