80 80
00000000000000000000000000000000000000000000000000000000000000000000000000000000
00000000000000000000000000000000000000000000000000000000000000000000000000000000
00000000000000000000000000000000000000000000000000000000000000000000000000000000
00000000000000000000000000000000000000000000000000000000000000000000000000000000
00000000000000000000000000000000000000000000000000000000000000000000000000000000
00000000000000000000000000000000000000000000000000000000000000000000000000000000
00000000000000000000000000000000000000000000000000000000000000000000000000000000
00000000000000000000000000000000000000000000000000000000000000000000000000000000
00000000000000000000000000000000000000000000000000000000000000000000000000000000
00000000000000000000000000000000000000000000000000000000000000000000000000000000
00000000000000000000000000000000000000000000000000000000000000000000000000000000
00000000000000000000000000000000000000000000000000000000000000000000000000000000
00000000000000000000000000000000000000000000000000000000000000000000000000000000
00000000000000000000000000000000000000000000000000000000000000000000000000000000
00000000000000000000000000000000000000000000000000000000000000000000000000000000
00000000000000000000000000000000000000000000000000000000000000000000000000000000
00000000000000000000000000000000000000000000000000000000000000000000000000000000
00000000000000000000000000000000000000000000000000000000000000000000000000000000
00000000000000000000000000000000000000000000000000000000000000000000000000000000
00000000000000000000000000000000000000000000000000000000000000000000000000000000
00000000000000000000000000000000000000000000000000000000000000000000000000000000
00000000000000000000000000000000000000000000000000000000000000000000000000000000
00000000000000000000000000000000000000000000000000000000000000000000000000000000
00000000000000000000000000000000000000000000000000000000000000000000000000000000
00000000000000000000000000000000000000000000000000000000000000000000000000000000
00000000000000000000000000000000000000000000000000000000000000000000000000000000
00000000000000000000000000000000000000000000000000000000000000000000000000000000
00000000000000000000000000000000000000000000000000000000000000000000000000000000
00000000000000000000000000000000000000000000000000000000000000000000000000000000
00000000000000000000000000000000000000000000000000000000000000000000000000000000
00000000000000000000000000000000000000000000000000000000000000000000000000000000
00000000000000000000000000000000000000000000000000000000000000000000000000000000
00000000000000000000000000000000000000000000000000000000000000000000000000000000
00000000000000000000000000000000000000000000000000000000000000000000000000000000
00000000000000000000000000000000000000000000000000000000000000000000000000000000
00000000000000000000000000000000000000000000000000000000000000000000000000000000
00000000000000000000000000000000000000000000000000000000000000000000000000000000
00000000000000000000000000000000000000000000000000000000000000000000000000000000
00000000000000000000000000000000000000000000000000000000000000000000000000000000
00000000000000000000000000000000000000000000000000000000000000000000000000000000
00000000000000000000000000000000000000000000000000000000000000000000000000000000
00000000000000000000000000000000000000000000000000000000000000000000000000000000
00000000000000000000000000000000000000000000000000000000000000000000000000000000
00000000000000000000000000000000000000000000000000000000000000000000000000000000
00000000000000000000000000000000000000000000000000000000000000000000000000000000
00000000000000000000000000000000000000000000000000000000000000000000000000000000
00000000000000000000000000000000000000000100000000000000000000000000000000000000
00000000000000000000000000000000000000000100000000000000000000000000000000000000
00000000000000000000000000000000000000000100000000000000000000000000000000000000
00000000000000000000000000000000000000001100000000000000000000000000000000000000
00000000000000000000000000000000001111101000111100000000000000000000000000000000
00000000000000000000000000000000000011111001111000000000000000000000000000000000
00000000000000000000000000000000000001100001111100000000000000000000000000000000
00000000000000000000000000000000000011100001111110000110000000000000000000000000
00000000000000000000000000000000000110111111110111001101000000000000000000000000
00000000000000000000000000000000000100011111111111111001000000000000000000000000
00000000000000000000000000000000001100001111001100010011000000000000000000000000
00000000000000000000000000000000001000000010000100000011000000000000000000000000
00000000000000000000000000000000001000000000100100011111100000000000000000000100
00000000000000000011100001000000001110111001111100111101100000000000000000001100
00000000000000000011110001000000001111011111111101110111000000000000000000011000
00000000000000000011110001000000000111011111111101111111000000000000000000110000
00000000000000000011110001100000000111111111001111111111000000000000000000110000
00000000000000000011000011100001000111001110000111110011001000011000000000110000
00000000000000000011100111100011100110001111001101100001001111111111100000010000
00000000000000000001111111100111101100011111111001100001001111111111111100010000
00000000000000000000011111110110001100110001100000100001100111111111110000110000
00000000000000000000000001111110001100100001000000100001111111111111110011110010
00000000000000000000000001111110011100110000100000010000111111001111111010011110
00000000000000000001101101111111110110011000110001110001111110001110111110011000
00000000000000000000101101000111001100001000011011110011111110001110111110110000
00000000000000000000111111000010001100001100011111111011111110000111101100110000
00000000000000000000011100000000000000000110110011111111111110001111100000011000
00000000000000000000001000000000000000000011100011111111121100001111100000001000
00000000000000000000011110000000000000000000000111100111111110001110111111111100
00000000000000000011110111100000000000000000000001110111111111101110111111111110
00000000000000000011000000000000000000000000000000111111111111111110011110111110
00000000000000000010000000000000000000000000000000111111100000111110001100000110
00000000000000000011111110000000000000000000000001110000000000111111001111000110
00000000000000000000000000000000000000000000000000000000000000000000000000000000
