80 80
00000000000000000000000000000000000000000000000000000000000000000000000000000000
00000000000000000000000000000000000000000000000000000000000000000000000000000000
00000000000000000000000000000000000000000000000000000000000000000000000000000000
00000000000000000000000000000000000000000000000000000000000000000000000000000000
00000000000000000000000000000000000000000000000000000000000000000000000000000000
00000000000000000000000000000000000000000000000000000000000000000000000000000000
00000000000000000000000000000000000000000000000000000000000000000000000000000000
00000000000000000000000000000000000000000000000000000000000000000000000000000000
00000000000000000000000000000000000000000000000000000000000000000000000000000000
00000000000000000000000000000000000000000000000000000000000000000000000000000000
00000000000000000000000000000000000000000000000000000000000000000000000000000000
00000000000000000000000000000000000000000000000000000000000000000000000000000000
00000000000000000000000000000000000000000000000000000000000000000000000000000000
00000000000000000000000000000000000000000000000000000000000000000000000000000000
00000000000000000000000000000000000000000000000000000000000000000000000000000000
00000000000000000000000000000000000000000000000000000000000000000000000000000000
00000000000000000000000000000000000000000000000000000000000000000000000000000000
00000000000000000000000000000000000000000000000000000000000000000000000000000000
00000000000000000000000000000000000000000000000000000000000000000000000000000000
00000000000000000000000000000010000000000000000000000000000000000000000000000000
00000000000000000000000000000010000000000000000000000000000000000000000000000000
00000000000000000000000000000010000000000000000000000000000000000000000000000000
00000000000000000000000000000011000000000000000000000000000000000000000000000000
00000000000000000000000000000001111100000000000000000000000000000000000000000000
00000000000000000000000000111111000100000000001111000000000000000000000000000000
00000000000000000000000011111111100100000001111111111000000000000000000000000000
00000000000000000000000011001111111000000111110011001000000000000000000000000000
00000000000000000000000000000111111000000111111000000000000000000000000000000000
00000000000000000000000000000111100000000001111100000000000000000000000000000000
00000000000000000000000000000011000000000000111111100000000000000000000000000000
00000000000000000000000000000111000000000001111111110000000000000000000000000000
00000000000000000000000000000110000000000000011111100000000000000000000000000000
00000000000000000010000000000111000000000111111110000000000000000000000000000000
00000000000000000111111000000011000000000111111100000000000000000000000000000000
00000000000000111111111000110011000000000000011100110000000000000000000000000000
00000000000000111111111111110111000000000000111111111000000000000000000000000000
00000000000000111111111110011110000000000000110011100000000000000000000000000000
00000000000000111001111100000110000000000000000001100000000000000000000000000000
00000000000001110000011000000110000001000000000011100000000000000000000000000000
00000000000011010000110000000010000011000000111111100000000000000000000000000000
00000000001110010001110000000011001110000001111111110000000000000000000000000000
00000000000110010000000000000011011100000000111100100000000000000000000000000000
00000000000000000000000100000011111000100000111100100000000000000000000000000000
00000000000000000000000110000011111101100001110001100000000000000000000000000000
00000000000000000000000011000111111111111001110001101000000000000000000000000000
00000000000000000000000001100111111111111111111000111000000000000000000000000000
00000000000000000000000001111111111211111111011000111100000000000000000000000000
00000000000000000000000011111111111111100011001101111100000000000000000000000000
00000000000000000000000011101111111111100001000111100000000000000000000000000000
00000000000000000000000011101111111111110000000001100000000000000000000000000000
00000000000000000000000011100111111111100000000000100000000000000000000000000000
00000000000000000000000001100011111111100000000000110000000000000000000000000000
00000000000000000000000000000001111000100000000000010000000000000000000000000000
00000000000000000000000000000001111000000000000000000000000000000000000000000000
00000000000000000000000000000011111100001000000000000000000000000000000000000000
00000000000000000000000000000011011110001000000000000000000000000000000000000000
00000000000000000000000000000000001111001000000000000000000000000000000000000000
00000000000000000000000000000000000111111000000000000000000000000000000000000000
00000000000000000000000000000000000111110000000000000000000000000000000000000000
00000000000000000000000000000000001111111000110000000000000000000000000000000000
00000000000000000000000000000010001111111100111111110000000000000000000000000000
00000000000000000000000000000011011110001100011100011000000000000000000000000000
00000000000000000000000000000011111110000000111100000000000000000000000000000000
00000000000000000000000000000011111110000000011000000000000000000000000000000000
00000000000000000000000000000011111111000000011000000000000000000000000000000000
00000000000000000000000111100111111111111110110000000000000000000000000000000000
00000000000000000000000100110011111110000111111000000000000000000000000000000000
00000000000000000000001100000011111111100011111000000000000000000000000000000000
00000000000000000000111110001111111111100011001000000000000000000000000000000000
00000000000000000001111111000111101100111111011000000000000000000000000000000000
00000000000000000001111111111111101100111111111000000000000000000000000000000000
00000000000000000000111011111111100110111111100000000000000000000000000000000000
00000000000000000000111101111111100011000011000000000000000000000000000000000000
00000000000000000000111111110111111000100010000000000000000000000000000000000000
00000000000000000000111111100011001100110011000000000000000000000000000000000000
00000000000000000000111111100010000110111110000000000000000000000000000000000000
00000000000000000000111111000010000111000000000000000000000000000000000000000000
00000000000000000000011000000011000011000000000000000000000000000000000000000000
00000000000000000000011000001111110011000000000000000000000000000000000000000000
00000000000000000000000000000000000000000000000000000000000000000000000000000000
