80 80
00000000000000000000000000000000000000000000000000000000000000000000000000000000
00000000000000011111110001100011111100000000000000000000000000000000000000000000
00000000000000000001110000110001111100000000000000000000000000000000000000000000
00000000000000000001111000010000111100000000000000000000000000000000000000000000
00000000000000000001111111111111111111111000000000000000000000000000000000000000
00000000000000000011110111111111111111111100000000000000000000000000000000000000
00000000000000000011110011111111111111111100000000000000000000000000000000000000
00000000000000000011100011111000111111111000000000000000000000000000000000000000
00000000000000000001100111111111000011111000000000000000000000000000000000000000
00000000000000000001111111111110000110011000000000000000000000000000000000000000
00000000000000000001111111121111001110001000000000000000000000000000000000000000
00000000000000000001111111111111111000001100000000000000000000000000000000000000
00000000000000000011111111111111100000001110000000000000000000000000000000000000
00000000000000000000111001111100000000001000000000000000000000000000000000000000
00000000000000000000111001111110000000001000000000000000000000000000000000000000
00000000000000000001110011100111000000001000000000000000000000000000000000000000
00000000000000000001100111000011000000000000000000000000000000000000000000000000
00000000000000000000000110000000000000000000000000000000000000000000000000000000
00000000000000000000001100000000000000000000000000000000000000000000000000000000
00000000000000000000011001111100000000000000000000000000000000000000000000000000
00000000000000000001110011101111000000000000000000000000000000000000000000000000
00000000000000000011100011100011100000000000000000000000000000000000000000000000
00000000000000000010000000100000000000000000000000000000000000000000000000000000
00000000000000000010111000100000000000000000000000000000000000000000000000000000
00000000000000000011111111100000000000000000000000000000000000000000000000000000
00000000000000000001111111100000000000000000000000000000000000000000000000000000
00000000000000000001111110000000000000000000000000000000000000000000000000000000
00000000000000000001111100000000000000000000000000000000000000000000000000000000
00000000000000000001111100000000000000000000000000000000000000000000000000000000
00000000001001110001111111000000000000000000000000000000000000000000000000000000
00000000001111111111111111111111000000000000000000000000000000000000000000000000
00000000001110011111111111110000000000000000000000000000000000000000000000000000
00000000000011111001111111110000000000000000000000000000000000000000000000000000
00000000000011000001111111110000000000000000000000000000000000000000000000000000
00000000011100001001110111110000000000000000000000000000000000000000000000000000
00000000111111111101110111110000000000000000000000000000000000000000000000000000
00000000011111100111111111110000000000000000000000000000000000000000000000000000
00000000000100000000001111000000000000000000000000000000000000000000000000000000
00000000000000000000001110000000000000000000000000000000000000000000000000000000
00000000000000000000011111000000000000000000000000000000000000000000000000000000
00000000000000000001111111100000000000000000000000000000000000000000000000000000
00000000000000000011000001110000000000000000000000000000000000000000000000000000
00000000000000000011000000110000000000000000000000000000000000000000000000000000
00000000000000000001000000100000000000000000000000000000000000000000000000000000
00000000000000000001100011000000000000000000000000000000000000000000000000000000
00000000000000000000100011100000000000000000000000000000000000000000000000000000
00000000000000000000110001100000000000000000000000000000000000000000000000000000
00000000000000000000111111100000000000000000000000000000000000000000000000000000
00000000000000000001100111111000000000000000000000000000000000000000000000000000
00000000000000000000100011111110000000000000000000000000000000000000000000000000
00000000000000000000100011100111000000000000000000000000000000000000000000000000
00000000000000000000100111100011000000000000000000000000000000000000000000000000
00000000000000000000001100000000000000000000000000000000000000000000000000000000
00000000000000000000000000000000000000000000000000000000000000000000000000000000
00000000000000000000000000000000000000000000000000000000000000000000000000000000
00000000000000000000000000000000000000000000000000000000000000000000000000000000
00000000000000000000000000000000000000000000000000000000000000000000000000000000
00000000000000000000000000000000000000000000000000000000000000000000000000000000
00000000000000000000000000000000000000000000000000000000000000000000000000000000
00000000000000000000000000000000000000000000000000000000000000000000000000000000
00000000000000000000000000000000000000000000000000000000000000000000000000000000
00000000000000000000000000000000000000000000000000000000000000000000000000000000
00000000000000000000000000000000000000000000000000000000000000000000000000000000
00000000000000000000000000000000000000000000000000000000000000000000000000000000
00000000000000000000000000000000000000000000000000000000000000000000000000000000
00000000000000000000000000000000000000000000000000000000000000000000000000000000
00000000000000000000000000000000000000000000000000000000000000000000000000000000
00000000000000000000000000000000000000000000000000000000000000000000000000000000
00000000000000000000000000000000000000000000000000000000000000000000000000000000
00000000000000000000000000000000000000000000000000000000000000000000000000000000
00000000000000000000000000000000000000000000000000000000000000000000000000000000
00000000000000000000000000000000000000000000000000000000000000000000000000000000
00000000000000000000000000000000000000000000000000000000000000000000000000000000
00000000000000000000000000000000000000000000000000000000000000000000000000000000
00000000000000000000000000000000000000000000000000000000000000000000000000000000
00000000000000000000000000000000000000000000000000000000000000000000000000000000
00000000000000000000000000000000000000000000000000000000000000000000000000000000
00000000000000000000000000000000000000000000000000000000000000000000000000000000
00000000000000000000000000000000000000000000000000000000000000000000000000000000
00000000000000000000000000000000000000000000000000000000000000000000000000000000
