80 80
00000000000000000000000000000000000000000000000000000000000000000000000000000000
00000000111111111111011111100000011000000000000000000000000000000000000000000000
00000000001111111110000111100000010000000000000000000000000000000000000000000000
00000000001110111100000001100000110000000000000000000000000000000000000000000000
00000000001110011111100001100001100000000000000000000000000000000000000000000000
00000000001100111111111111110111000000000000000000000000000000000000000000000000
00000000000000110011111111001110000000000000000000000000000000000000000000000000
00000000000001000010000000001111111000000000000000000000000000000000000000000000
00000000000001000010000000111110010000000000000000000000000000000000000000000000
00000000000111111111111111111100001010000000010000000000000000000000000000000000
00000000001111111111111111111111001111011110010000000000000000000000000000000000
00000000000001111111111111100001111111110011110000000000000000000000000000000000
00000000000001111111211111000000000001000001111000000000000000000000000000000000
00000000000001111111111111000010000011000001001100000000000000000000000000000000
00000000000000110111111111111110000111111111111100000000000000000000000000000000
00000000000001111111111111111111001111111111111000000000000000000000000000000000
00000000000000011110001111110011001111111100000000000000000000000000000000000000
00000000000000000110000111111111001111111100000000000000000000000000000000000000
00000000000000000010000011110110001110111100000000000000000000000000000000000000
00000000000000000011110001100110001110011110000000000000000000000000000000000000
00000000000000000011111011100111001110011100000000000000000000000000000000000000
00000000000000000001111111100011101110011100000000000000000000000000000000000000
00000000000000000000001000110001111110011000000000000000000000000000000000000000
00000000000000000000000000000001111100001110000000000000000000000000000000000000
00000000000000000000000000000011001110001100011000000000000000000000000000000000
00000000000000000000000011100010001111011100111000000000000000000000000000000000
00000000000000000000000000110110000111111000110000000000000000000000000000000000
00000000000000000000000000011100001111100000110000000000000000000000000000000000
00000000000000000000000000111000011001100000110000000000000000000000000000000000
00000000000000000000000001101011111101100110110000000000000000000000000000000000
00000000000000000000000001000111111111111111110000000000000000000000000000000000
00000000000000000000000001000110110001110000100000000000000000000000000000000000
00000000000000000000000000000000100000100000000000000000000000000000000000000000
00000000000000000000000000000000000000100000000000000000000000000000000000000000
00000000000000000000000000000000000000000000000000000000000000000000000000000000
00000000000000000000000000000000000000000000000000000000000000000000000000000000
00000000000000000000000000000000000000000000000000000000000000000000000000000000
00000000000000000000000000000000000000000000000000000000000000000000000000000000
00000000000000000000000000000000000000000000000000000000000000000000000000000000
00000000000000000000000000000000000000000000000000000000000000000000000000000000
00000000000000000000000000000000000000000000000000000000000000000000000000000000
00000000000000000000000000000000000000000000000000000000000000000000000000000000
00000000000000000000000000000000000000000000000000000000000000000000000000000000
00000000000000000000000000000000000000000000000000000000000000000000000000000000
00000000000000000000000000000000000000000000000000000000000000000000000000000000
00000000000000000000000000000000000000000000000000000000000000000000000000000000
00000000000000000000000000000000000000000000000000000000000000000000000000000000
00000000000000000000000000000000000000000000000000000000000000000000000000000000
00000000000000000000000000000000000000000000000000000000000000000000000000000000
00000000000000000000000000000000000000000000000000000000000000000000000000000000
00000000000000000000000000000000000000000000000000000000000000000000000000000000
00000000000000000000000000000000000000000000000000000000000000000000000000000000
00000000000000000000000000000000000000000000000000000000000000000000000000000000
00000000000000000000000000000000000000000000000000000000000000000000000000000000
00000000000000000000000000000000000000000000000000000000000000000000000000000000
00000000000000000000000000000000000000000000000000000000000000000000000000000000
00000000000000000000000000000000000000000000000000000000000000000000000000000000
00000000000000000000000000000000000000000000000000000000000000000000000000000000
00000000000000000000000000000000000000000000000000000000000000000000000000000000
00000000000000000000000000000000000000000000000000000000000000000000000000000000
00000000000000000000000000000000000000000000000000000000000000000000000000000000
00000000000000000000000000000000000000000000000000000000000000000000000000000000
00000000000000000000000000000000000000000000000000000000000000000000000000000000
00000000000000000000000000000000000000000000000000000000000000000000000000000000
00000000000000000000000000000000000000000000000000000000000000000000000000000000
00000000000000000000000000000000000000000000000000000000000000000000000000000000
00000000000000000000000000000000000000000000000000000000000000000000000000000000
00000000000000000000000000000000000000000000000000000000000000000000000000000000
00000000000000000000000000000000000000000000000000000000000000000000000000000000
00000000000000000000000000000000000000000000000000000000000000000000000000000000
00000000000000000000000000000000000000000000000000000000000000000000000000000000
00000000000000000000000000000000000000000000000000000000000000000000000000000000
00000000000000000000000000000000000000000000000000000000000000000000000000000000
00000000000000000000000000000000000000000000000000000000000000000000000000000000
00000000000000000000000000000000000000000000000000000000000000000000000000000000
00000000000000000000000000000000000000000000000000000000000000000000000000000000
00000000000000000000000000000000000000000000000000000000000000000000000000000000
00000000000000000000000000000000000000000000000000000000000000000000000000000000
00000000000000000000000000000000000000000000000000000000000000000000000000000000
00000000000000000000000000000000000000000000000000000000000000000000000000000000
