80 80
00000000000000000000000000000000000000000000000000000000000000000000000000000000
00011111111100011111111111101111111100000000000000000000000000000000000000000000
00000000100100001111001111111111111000000000000000000000000000000000000000000000
00001000000100001001111111100111110000000000000000000000000000000000000000000000
01101100101100011001111111100111000000000000000000000000000000000000000000000000
01111111111101111001111111100111000000000000000000000000000000000000000000000000
01111111111111111000111111111111110000000000000000000000000000000000000000000000
00010000111111111101111111111100100000000011000000000000000000000000000000000000
00000000111111111111111100011100110000000011000000000000000000000000000000000000
00000001111111111101111111111110111000011111000000000000000000000000000000000000
01011111111111111111111111110111011110011111111000000000000000000000000000000000
01110001111111111111100001100011000110011011000000000000000000000000000000000000
00000001100011100111000001100001000111110010000000000000000000000000000000000000
00000001100001100111000111100000001110110000000000000000000000000000000000000000
01000111111000111111100111100011011100011100000000000000000000000000000000000000
01101111111100111111111111100111001110111110000000000000000000000000000000000000
00111101111110011100111111100110000111111111000000000000000000000000000000000000
00011001100010000000110001111111011111100001000000000000000000000000000000000000
00110001100011000000100001111111111111000000000000000000000000000000000000000000
01111111101111110011100001100110000110000000000000000000000000000000000000000000
01001111111111111101110011110110001110000000000000000000000000000000000000000000
00000111111111011000111111110011111100000000000000000000000000000000000000000000
00000111111110001001111000111111111000000000000000000000000000000000000000000000
01111111111000001111111101111111111100000000000000000000000000000000000000000000
01001111111100011111111111111111111100000000000000000000000000000000000000000000
01011111111100111111111111111111001110000000000000000000000000000000000000000000
00011111111100110111111111111110000000000000000000000000000000000000000000000000
00010000111000100011111121111110000000000000000000000000000000000000000000000000
00010000111000100011111111111111000000000000000000000000000000000000000000000000
00010011111000110001111111111111100000000000000000000000000000000000000000000000
01111111111100111001111111111111100000000000000000000000000000000000000000000000
01111100001110011000111111001111110000000000000000000000000000000000000000000000
01111100000010001100011100000111100000000000000000000000000000000000000000000000
01111100000000000100011000000001100000000000000000000000000000000000000000000000
00000110000001101100111111000011000000000000000000000000000000000000000000000000
00000100000000111001110111100111000000000000000000000000000000000000000000000000
00000000000000000001110110111110000000000000000000000000000000000000000000000000
00000000000000000000111100001100000000000000000000000000000000000000000000000000
00000000000000000000011000000110000000000000000000000000000000000000000000000000
00000000000000000000110000000110000000000000000000000000000000000000000000000000
00000000000000000001100000000010000000000000000000000000000000000000000000000000
00000000000000000011000000000010000000000000000000000000000000000000000000000000
00000000000000000010000000000000000000000000000000000000000000000000000000000000
00000000000000000010000000000000000000000000000000000000000000000000000000000000
00000000000000000011000000000000000000000000000000000000000000000000000000000000
00000000000000000001100000000000000000000000000000000000000000000000000000000000
00000000000000000000110000000000000000000000000000000000000000000000000000000000
00000000000000000001110000000000000000000000000000000000000000000000000000000000
00000000000000000001000000000000000000000000000000000000000000000000000000000000
00000000000000000000000000000000000000000000000000000000000000000000000000000000
00000000000000000000000000000000000000000000000000000000000000000000000000000000
00000000000000000000000000000000000000000000000000000000000000000000000000000000
00000000000000000000000000000000000000000000000000000000000000000000000000000000
00000000000000000000000000000000000000000000000000000000000000000000000000000000
00000000000000000000000000000000000000000000000000000000000000000000000000000000
00000000000000000000000000000000000000000000000000000000000000000000000000000000
00000000000000000000000000000000000000000000000000000000000000000000000000000000
00000000000000000000000000000000000000000000000000000000000000000000000000000000
00000000000000000000000000000000000000000000000000000000000000000000000000000000
00000000000000000000000000000000000000000000000000000000000000000000000000000000
00000000000000000000000000000000000000000000000000000000000000000000000000000000
00000000000000000000000000000000000000000000000000000000000000000000000000000000
00000000000000000000000000000000000000000000000000000000000000000000000000000000
00000000000000000000000000000000000000000000000000000000000000000000000000000000
00000000000000000000000000000000000000000000000000000000000000000000000000000000
00000000000000000000000000000000000000000000000000000000000000000000000000000000
00000000000000000000000000000000000000000000000000000000000000000000000000000000
00000000000000000000000000000000000000000000000000000000000000000000000000000000
00000000000000000000000000000000000000000000000000000000000000000000000000000000
00000000000000000000000000000000000000000000000000000000000000000000000000000000
00000000000000000000000000000000000000000000000000000000000000000000000000000000
00000000000000000000000000000000000000000000000000000000000000000000000000000000
00000000000000000000000000000000000000000000000000000000000000000000000000000000
00000000000000000000000000000000000000000000000000000000000000000000000000000000
00000000000000000000000000000000000000000000000000000000000000000000000000000000
00000000000000000000000000000000000000000000000000000000000000000000000000000000
00000000000000000000000000000000000000000000000000000000000000000000000000000000
00000000000000000000000000000000000000000000000000000000000000000000000000000000
00000000000000000000000000000000000000000000000000000000000000000000000000000000
00000000000000000000000000000000000000000000000000000000000000000000000000000000
