80 80
00000000000000000000000000000000000000000000000000000000000000000000000000000000
00000000000000000000000000000000000000000000000000000000000000000000000000000000
00000000000000000000000000000000000000000000000000000000000000000000000000000000
00000000000000000000000000000000000000000000000000000000000000000000000000000000
00000000000000000000000000000000000000000000000000000000000000000000000000000000
00000000000000000000000000000000000000000000000000000000000000000000000000000000
00000000000000000000000000000000000000000000000000000000000000000000000000000000
00000000000000000000000000000000000000000000000000000000000000000000000000000000
00000000000000000000000000000000000000000000000000000000000000000111000000000000
00000000000000000000000000000000000000000000000000000000000100001100000000000000
00000000000000000000000000000000000000000000000000000000000111001110000000000000
00000000000000000000000000000000000000000000000000000000000111000110000000000000
00000000000000000000000000000000000000000000000000000000001111000010000000000000
00000000000000000000000000000000000000000000000000000000111111000110000000000000
00000000000000000000000000000000000000000000000000000001100011100100000000000000
00000000000000000000000000000000000000000000000000000011100111100100000000000000
00000000000000000000000000000000000000000000000000000111000111111100000000000000
00000000000000000000000000000000000000000000000000000100001100111000000000000000
00000000000000000000000000000000000000000000000000001100001001111000010000000000
00000000000000000000000000000000000000000000000000011110111111111100011001110000
00000000000000000000000000000000000000000000000001111111111111001110001111111110
00000000000000000000000000000000000000000000000001000111110011000110011111111110
00000000000000000000000000000000000000000000000000000111000011001111111011111110
00000000000000000000000000000000000000000000000000000011110001111111111001112110
00000000000000000000000000000000000000000000000000000001110111111111111111111110
00000000000000000000000000000000000000000000000000000011101111111111111111111110
00000000000000000000000000000000000000000000000000000011001111001111111111111110
00000000000000000000000000000000000000000000000000001110001100000011000011100010
00000000000000000000000000000000000000000000000000000000001100001111000011100010
00000000000000000000000000000000000000000000000000000000001110011111111111110010
00000000000000000000000000000000000000000000000000000000000111111111111110111100
00000000000000000000000000000000000000000000000000000000000011111111111100011100
00000000000000000000000000000000000000000000000000000000000001111111100000111000
00000000000000000000000000000000000000000000000000000000000000001000000001111100
00000000000000000000000000000000000000000000000000000000000000001100011111111100
00000000000000000000000000000000000000000000000000000000000000011110011111111100
00000000000000000000000000000000000000000000000000000000000000010011111111110000
00000000000000000000000000000000000000000000000000000000000000010001000010000000
00000000000000000000000000000000000000000000000000000000000000011000000010000000
00000000000000000000000000000000000000000000000000000000000000000000000000000000
00000000000000000000000000000000000000000000000000000000000000000000000000000000
00000000000000000000000000000000000000000000000000000000000000000000000000000000
00000000000000000000000000000000000000000000000000000000000000000000000000000000
00000000000000000000000000000000000000000000000000000000000000000000000000000000
00000000000000000000000000000000000000000000000000000000000000000000000000000000
00000000000000000000000000000000000000000000000000000000000000000000000000000000
00000000000000000000000000000000000000000000000000000000000000000000000000000000
00000000000000000000000000000000000000000000000000000000000000000000000000000000
00000000000000000000000000000000000000000000000000000000000000000000000000000000
00000000000000000000000000000000000000000000000000000000000000000000000000000000
00000000000000000000000000000000000000000000000000000000000000000000000000000000
00000000000000000000000000000000000000000000000000000000000000000000000000000000
00000000000000000000000000000000000000000000000000000000000000000000000000000000
00000000000000000000000000000000000000000000000000000000000000000000000000000000
00000000000000000000000000000000000000000000000000000000000000000000000000000000
00000000000000000000000000000000000000000000000000000000000000000000000000000000
00000000000000000000000000000000000000000000000000000000000000000000000000000000
00000000000000000000000000000000000000000000000000000000000000000000000000000000
00000000000000000000000000000000000000000000000000000000000000000000000000000000
00000000000000000000000000000000000000000000000000000000000000000000000000000000
00000000000000000000000000000000000000000000000000000000000000000000000000000000
00000000000000000000000000000000000000000000000000000000000000000000000000000000
00000000000000000000000000000000000000000000000000000000000000000000000000000000
00000000000000000000000000000000000000000000000000000000000000000000000000000000
00000000000000000000000000000000000000000000000000000000000000000000000000000000
00000000000000000000000000000000000000000000000000000000000000000000000000000000
00000000000000000000000000000000000000000000000000000000000000000000000000000000
00000000000000000000000000000000000000000000000000000000000000000000000000000000
00000000000000000000000000000000000000000000000000000000000000000000000000000000
00000000000000000000000000000000000000000000000000000000000000000000000000000000
00000000000000000000000000000000000000000000000000000000000000000000000000000000
00000000000000000000000000000000000000000000000000000000000000000000000000000000
00000000000000000000000000000000000000000000000000000000000000000000000000000000
00000000000000000000000000000000000000000000000000000000000000000000000000000000
00000000000000000000000000000000000000000000000000000000000000000000000000000000
00000000000000000000000000000000000000000000000000000000000000000000000000000000
00000000000000000000000000000000000000000000000000000000000000000000000000000000
00000000000000000000000000000000000000000000000000000000000000000000000000000000
00000000000000000000000000000000000000000000000000000000000000000000000000000000
00000000000000000000000000000000000000000000000000000000000000000000000000000000
