80 80
00000000000000000000000000000000000000000000000000000000000000000000000000000000
00000000000000000000000000000000000000000000000000000000000000000000000000000000
00000000000000000000000000000000000000000000000000000000000000000000000000000000
00000000000000000000000000000000000000000000000000000000000000000000000000000000
00000000000000000000000000000000000000000000000000100000000000000000000000000000
00000000000000000000000000000000000000000000000000100011100010000000000000000000
00000000000000000000000000000000000000000000000000110001100010000000000000000000
00000000000000000000000000000000000000000000000000011011111110000000000000000000
00000000000000000000000000000000000000000000000000011110011111100000000000000000
00000000000000000000000000000000000000000000000000111111000111111000000000000000
00000000000000000000000000000000000000000000000001111111100111111111111000000000
00000000000000000000000000000000000000000000000011111101000111100011000000000000
00000000000000000000000000000000000000000001000011100000111101100000000000000000
00000000000000000000000000000000000000000011000011000001110000000000000000000000
00000000000000000000000000000000000000000111100111100001000010001100000000011000
00000000000000000000000000000000000000000000111111110001000111111110011000111000
00000000000000000000000000000000000000000000001000111001101111111111101110111000
00000000000000000000000000000000000000000000000000011111111100000001100101111100
00000000000000000000000000000000000000000010000000011111111111100000000111110110
00000000000000000000000000000000000000000110011001111111111111110000001111111110
00000000000000000000000000000000000000011100111111111111111111111111011111111110
00000000000000000000000000000000000000001000111111111111100111111011111011110010
00000000000000000000000000000000000001111111110111111100000000110001110011100000
00000000000000000000000000000000000001111111111111111100000000011000000110000000
00000000000000000000000000000000000011100000111101111111111110001100001111100000
00000000000000000000000000000000000000011111111001110111111111001110001000111000
00000000000000000000000000000000000000000011111000110001100111001110011000000000
00000000000000000000000000000000000000000001011101111000000111000111111100000000
00000000000000000000000000000000000000000000001111111000001111011110001110000000
00000000000000000000000000000000000000000011001111111110001111111100001100000000
00000000000000000000000000000000000000000011111111111111111111111110001000000000
00000000000000000000000000000000000000000000000011111000110011111110011000000000
00000000000000000000000000000000000000000000000000011000010001111110011100000000
00000000000000000000000000000000000000000000000000011000010001111111111000000000
00000000000000000000000000000000000000000000000001111000111011111111111000000000
00000000000000000000000000000000000000000000000001111111111111111111111000000000
00000000000000000000000000000000000000000000000001111100001111111111111100000000
00000000000000000000000000000000000000000000000001111000001100011111111000000000
00000000000000000000000000000000000000000000000000111110011000001111111000110000
00000000000000000000000000000000000000000000000000110011111111101111111111110000
00000000000000000000000000000000000000000000000001100011111111111110011111110000
00000000000000000000000000000000000000000000000001100001111111111100011111111000
00000000000000000000000000000000000000000000000000000001111100001111111111001110
00000000000000000000000000000000000000000000000000000001111110001111111111100010
00000000000000000000000000000000000000000000000001101001111111001110011111110000
00000000000000000000000000000000000000000000000000101111111111001111111111111000
00000000000000000000000000000000000000000000000000111111111110001111111110011110
00000000000000000000000000000000000000000000000000110000001111011111111111000100
00000000000000000000000000000000000000000000000000100000000111111100011111100000
00000000000000000000000000000000000000000000000000100001000111111110011111111110
00000000000000000000000000000000000000000000000000100011100111111111111100111110
00000000000000000000000000000000000000000000000001100001110111111111111100011110
00000000000000000000000000000000000000000000000000000000111110111111111100000000
00000000000000000000000000000000000000000000000000000000111110110111111111000000
00000000000000000000000000000000000000000000000000000001001111111111111111110000
00000000000000000000000000000000000000000000000000100001000111111110111111111000
00000000000000000000000000000000000000000000000001100001100011111110111111111000
00000000000000000000000000000000000000000000000011110001100000011111111111111000
00000000000000000000000000000000000000000000000011011111110000011111111111111000
00000000000000000000000000000000000000000000000011000111111110111111111111111000
00000000000000000000000000000000000000000000000001110011111111111111111111111110
00000000000000000000000000000000000000000000000000010111111011111111121111111110
00000000000000000000000000000000000000000000000000000111011001111111111111001110
00000000000000000000000000000000000000000000000000000001111111111111111111110000
00000000000000000000000000000000000000000000000000000001101111111111111111110000
00000000000000000000000000000000000000000000000000000001101111111111111111111000
00000000000000000000000000000000000000000000000000000011000111111111111110111100
00000000000000000000000000000000000000000000000000000011101111111000110000001110
00000000000000000000000000000000000000000000000000011111001111111000111001110110
00000000000000000000000000000000000000000000000000110011001111111100011111111110
00000000000000000000000000000000000000000000000000100001101111111110011111111110
00000000000000000000000000000000000000000000000011100001111111111110011111111110
00000000000000000000000000000000000000000000000011100000011111000011111100011110
00000000000000000000000000000000000000000000000010000000111110000011110000011100
00000000000000000000000000000000000000000000000011001001100110000111111000011000
00000000000000000000000000000000000000000000111111111111000011001111111100010000
00000000000000000000000000000000000000000000000000111111000011011111001100110000
00000000000000000000000000000000000000000000000001111100000110010001000111110000
00000000000000000000000000000000000000000000000000110000111100000001001111111000
00000000000000000000000000000000000000000000000000000000000000000000000000000000
