80 80
00000000000000000000000000000000000000000000000000000000000000000000000000000000
00000000000000000000000000000000000000000000000000000000000000000000000000000000
00000000000000000000000000000000000000000000000000000000000000000000000000000000
00000000000000000000000000000000000000000000000000000000000000000000000000000000
00000000000000000000000000000000000000000000000000000000000000000000000000000000
00000000000000000000000000000000000000000000000000000000000000000000000000000000
00000000000000000000000000000000000000000000000000000000000000000000000000000000
00000000000000000000000000000000000000000000000000000000000000000000000000000000
00000000000000000000000000000000000000000000000000000000000000000000000000000000
00000000000000000000000000000000000000000000000000000000000000000000000000000000
00000000000000000000000000000000000000000000000000000000000000000000000000000000
00000000000000000000000000000000000000000000000000000000000000000000000000000000
00000000000000000000000000000000000000000000000000000000000000000000000000001000
00000000000000000000000000000000000000000000000000000000000000000000000000001110
00000000000000000000000000000000000000000000000000010000000000000000000000011110
00000000000000000000000000000000000000000000000001110000000000000000000000011110
00000000000000000000000000000000000000000000000000110000000000000000000000110110
00000000000000000000000000000000000000000000000001111000000000000000000000111110
00000000000000000000000000000000000000000000000001110000011110001000000001111110
00000000000000000000000000000000000000000010000001100001111111111100011101111110
00000000000000000000000000000000000000001110000000111111111111101110111111111110
00000000000000000000000000000000000000000110000000111111001111100111111110011100
00000000000000000000000000000000000000000010000000001111111111100011111110001100
00000000000000000000000000000000000000000010000000001111101111100001111110001110
00000000000000000000000000000000011000010010001111111111001111011111001100011010
00000000000000000000000000000000001111111111111111111011111111111111111100111010
00000000000000000000000000000000000010001111000011000001110011111111111000010010
00000000000000000000000000000000000000001110000000000000000011111111000000011110
00000000000000000000000000000000000000001100000000000000000111110111100000011000
00000000000000000000000000000000000000001100000000001111111111111111111000011000
00000000000000000000000000000000000000001000000001111111111111111111111100111000
00000000000000000000000000000000000000111000000011000111111111111111111101110000
00000000000000000000000000000000000000100000000010000011121111111111001111100000
00000000000000000000000000000000000000000000100000000011111110001110001111100000
00000000000000000000000000000000000000000000100110001111111110001110001111111000
00000000000000000000000000000000000000000000111111111111110111001110011101111000
00000000000000000000000000000000000000000000000110000001100001111110011000111000
00000000000000000000000000000000000000000000000010000000100000111100000000111000
00000000000000000000000000000000000000000000000010000000110000110000000000011000
00000000000000000000000000000000000000000000000000000001111111111111000110011000
00000000000000000000000000000000000000000000000000000011111111111111111111110000
00000000000000000000000000000000000000000000000000000001001111000000111011110000
00000000000000000000000000000000000000000000000000000000000100000000110011000000
00000000000000000000000000000000000000000000000000000000000000000000000000000000
00000000000000000000000000000000000000000000000000000000000000000000000000000000
00000000000000000000000000000000000000000000000000000000000000000000000000000000
00000000000000000000000000000000000000000000000000000000000000000000000000000000
00000000000000000000000000000000000000000000000000000000000000000000000000000000
00000000000000000000000000000000000000000000000000000000000000000000000000000000
00000000000000000000000000000000000000000000000000000000000000000000000000000000
00000000000000000000000000000000000000000000000000000000000000000000000000000000
00000000000000000000000000000000000000000000000000000000000000000000000000000000
00000000000000000000000000000000000000000000000000000000000000000000000000000000
00000000000000000000000000000000000000000000000000000000000000000000000000000000
00000000000000000000000000000000000000000000000000000000000000000000000000000000
00000000000000000000000000000000000000000000000000000000000000000000000000000000
00000000000000000000000000000000000000000000000000000000000000000000000000000000
00000000000000000000000000000000000000000000000000000000000000000000000000000000
00000000000000000000000000000000000000000000000000000000000000000000000000000000
00000000000000000000000000000000000000000000000000000000000000000000000000000000
00000000000000000000000000000000000000000000000000000000000000000000000000000000
00000000000000000000000000000000000000000000000000000000000000000000000000000000
00000000000000000000000000000000000000000000000000000000000000000000000000000000
00000000000000000000000000000000000000000000000000000000000000000000000000000000
00000000000000000000000000000000000000000000000000000000000000000000000000000000
00000000000000000000000000000000000000000000000000000000000000000000000000000000
00000000000000000000000000000000000000000000000000000000000000000000000000000000
00000000000000000000000000000000000000000000000000000000000000000000000000000000
00000000000000000000000000000000000000000000000000000000000000000000000000000000
00000000000000000000000000000000000000000000000000000000000000000000000000000000
00000000000000000000000000000000000000000000000000000000000000000000000000000000
00000000000000000000000000000000000000000000000000000000000000000000000000000000
00000000000000000000000000000000000000000000000000000000000000000000000000000000
00000000000000000000000000000000000000000000000000000000000000000000000000000000
00000000000000000000000000000000000000000000000000000000000000000000000000000000
00000000000000000000000000000000000000000000000000000000000000000000000000000000
00000000000000000000000000000000000000000000000000000000000000000000000000000000
00000000000000000000000000000000000000000000000000000000000000000000000000000000
00000000000000000000000000000000000000000000000000000000000000000000000000000000
00000000000000000000000000000000000000000000000000000000000000000000000000000000
