80 80
00000000000000000000000000000000000000000000000000000000000000000000000000000000
00000000000000000000000000000000000000000000000000000000000000000000000000000000
00000000000000000000000000000000000000000000000000000000000000000000000000000000
00000000000000000000000000000000000000000000000000000000000000000000000000000000
00000000000000000000000000000000000000000000000000000000000000000000000000000000
00000000000000000000000000000000000000000000000000000000000000000000000000000000
00000000000000000000000000000000000000000000000000000000000000000000000000000000
00000000000000000000000000000000000000000000000000000000000000000000000000000000
00000000000000000000000000000000000000000000000000000000000000000000000000000000
00000000000000000000000000000000000000000000000000000000000000000000000000000000
00000000000000000000000000000000000000000000000000000000000000000000000000000000
00000000000000000000000000000000000000000000000000000000000000000000000000000000
00000000000000000000000000000000000000000000000000000000000000000000000000000000
00000000000000000000000000000000000000000000000000000000000000000000000000000000
00000000000000000000000000000000000000000000000000000000000000000000000000000000
00000000000000000000000000000000000000000000000000000000000000000000000000000000
00000000000000000000000000000000000000000000000000000000000000000000000000000000
00000000000000000000000000000000000000000000000000000000000000000000000000000000
00000000000000000000000000000000000000000000000000000000000000000000000000000000
00000000000000000000000000000000000000000000000000000000000000000000000000000000
00000000000000000000000000000000000000000000000000000000000000000000000000000000
00000000000000000000000000000000000000000000000000000000000000000000000000000000
00000000000000000000000000000000000000000000000000000000000000000000000000000000
00000000000000000000000000000000000000000000000000000000000000000000000000000000
00000000000000000000000000000000000000000000000000000000000000000000000000000000
00000000000000000000000000000000000000000000000000000000000000000000000000000000
00000000000000000000000000000000000000000000000000000000000000000000000000000000
00000000000000000000000000000000000000000000000000000000000000000000000000000000
00000000000000000000000000000000000000000000000000000000000000000000000000000000
00000000000000000000000000000000000000000000000000000000000000000000000000000000
00000000000000000000000000000000000000000000000000000000000000000000000000000000
00000000000000000000000000000000000000000000000000000000000000000000000000000000
00000000000000000000000000000000000000000000000000000000000000000000000000000000
00000000000000000000000000000000000000000000000000000000000000000000000000000000
00000000000000000000000000000000000000000000000000000000000000000000000000000000
00000000000000000000000000000000000000000000000000000000000000000000000000000000
00000000000000000000000000000000000000000000000000000000000000000000000000000000
00000000000000000000000000000000000000000000000000000000000000000000000000000000
00000000000000000000000000000000000000000000000000000000000000000000000000000000
00000000000000000000000000000000000000000000000000000000000000000000000000000000
00000000000000000000000000000000000000000000000000000000000000000000000000000000
00000000000000000000000000000000000000000000000000000000000000000000000000000000
00000000000000000000000000000000000000000000000000000000000000000000000000000000
00000000000000000000100000000000000000100001000100000000000000000000000000000000
00000000000000000000100000000000000000110011110100000000000000000000000000000000
00000000000000000000100000000000000000011111111100100000000000000000000000000000
00000000000000000000100000000000000000011110011101100000000000000000000000000000
00000000000000000111110000000000000000111110011111000000000000000000000000000000
00000000000000000001110000000000000000111111110011000000000000000000000000000000
00000000000000000001100000000110010100111001110001100000000000000000000000000000
00000000000000000000111111110111111111111110110000100000000000000000000000000000
00000000000000000000111110111011110110111110011000100000000000000000000000000000
00000000000000000000001000001111100001111111111000111000000000000000000000000000
00000000000000000000000000000011000111110011111110111111100000000000000000000000
00000000000000000000000000000011000100111111111100110001000000000000000000000000
00000000000000000000000000000111000110111111111111110001000000000000000000000000
00000000000000000000000000000110000111111100111111100001000000000000000000000000
00000000000000000000000000001110001111100000000001100111100000000000000000000000
00000000000000000000000010001110011111111001100001110000100000000000000000000000
00000000000000000001100011000111101111111111110001100000100000000000000000000000
00000000000000000001110011100111001112111111111001110000000000000000000000000000
00000000000000000000110001111111001111111111011111110000000000000000000000000000
00000000000000000000110000011111111111111001011111111100000000000000000000000000
00000000000000101000110000000111111110010000011100001000000000000000000000000000
00000000001000111001110011000111001100000000011000011000000000000000000000000000
00000000001000111001111111100111001110000000010001111111000000000000000000000000
00000000001000111001111001111110000110000000010000000110000000000000000000000000
00000000001100111000110000111110000010000000011000000100000000000000000000000000
00000000001110011000000000111110000001000000001100001111000000000000000000000000
00000000001101111100110011111110000011001100011100010001000000000000000000000000
00000000111101111111111011100111111110011111111111110001000000000000000000000000
00000000001111111111001111100011111000001111111011000000000000000000000000000000
00000000001111110100000111100001110000000110000000000000000000000000000000000000
00000000001111110000000011110011100010000000000000000000000000000000000000000000
00000000001111111111100011001111111111100000000000000000000000000000000000000000
00000000001111111111110001101111111110111100000000000000000000000000000000000000
00000000001111111110110011101111111100000000000000000000000000000000000000000000
00000000001111111100111111001110011100000000000000000000000000000000000000000000
00000000000000111111111110001110011100000000000000000000000000000000000000000000
00000000000000000000000000000000000000000000000000000000000000000000000000000000
