80 80
00000000000000000000000000000000000000000000000000000000000000000000000000000000
00000000000000000000000000000000000000000000000000000000000000000000000000000000
00000000000000000000000000000000000000000000000000000000000000000000000000000000
00000000000000000000000000000000000000000000000000000000000000000000000000000000
00000000000000000000000000000000000000000000000000000000000000000000000000000000
00000000000000000000000000000000000000000000000000000000000000000000000000000000
00000000000000000000000000000000000000000000000000000000000000000000000000000000
00000000000000000000000000000000000000000000000000000000000000000000000000000000
00000000000000000000000000000000000000000000000000000000000000000000000000000000
00000000000000000000000000000000000000000000000000000000000000000000000000000000
00000000000000000000000000000000000000000000000000000000000000000000000000000000
00000000000000000000000000000000000000000000000000000000000000000000000000000000
00000000000000000000000000000000000000000000000000000000000000000000000000000000
00000000000000000000000000000000000000000000000000000000000000000000000000000000
00000000000000000000000000000000000000000000000000000000000000000000000000000000
00000000000000000000000000000000000000000000000000000000000000000000000000000000
00000000000000000000000000000000000000000000000000000000000000000000000000000000
00000000000000000000000000000000000000000000000000000000000000000000000000000000
00000000000000000000000000000000000000000000000000000000000000000000000000000000
00000000000000000000000000000000000000000000000000000000000000000000000000000000
00000000000000000000000000000000000000000000000000000000000000000000000000000000
00000000000000000000000000000000000000000000000000000000000000000000000000000000
00000000000000000000000000000000000000000000000000000000000000000000000000000000
00000000000000000000000000000000000000000000000000000000000000000000000000000000
00000000011000000000100000000000000000000000000000000000000000000000000000000000
00000000011000000000100000000000000000000000000000000000000000000000000000000000
00000000001100000000100000000000000000000000000000000000000000000000000000000000
00000000000100000000100000000000000000000000000000000000000000000000000000000000
00000000000100000000110000000000000000000000000000000000000000000000000000000000
00000110001111111000110000000000000000000000000000000000000000000000000000000000
00001111111101111101110000000000000000000000000000000000000000000000000000000000
01111101111101111111100000000000000000000000000000000000000000000000000000000000
01110001111111000111000000000000000000000000000000000000000000000000000000000000
01100001111111000011000000000000000000000000000000000000000000000000000000000000
01110111111111110111111001100000000000000000000000000000000000000000000000000000
01111111111111111111111111000000000000000000000000000000000000000000000000000000
01111111100110011111111111000000000000000000000000000000000000000000000000000000
00111111000000000000011110000000000000000000000000000000000000000000000000000000
00111111000001000000011111110000000000000000000000000000000000000000000000000000
01111110000111111000111111110000000000000000000000000000000000000000000000000000
01111111111101111111111111100000000000000000000000000000000000000000000000000000
00000001111000111111100111100000000000000000000000000000000000000000000000000000
00000000000000000110000111110000000000000000000000000000000000000000000000000000
00000000000000000111000111000000000000000000000000000000000000000000000000000000
00000000111100111111101111000010000000000000000000000000000000000000000000000000
00000111111111111111111111000010000000000000000000000000000000000000000000000000
00000001111111111100111001000110000000000000000000000000000000000000000000000000
00000001000111111100000010001100000000000000000000000000000000000000000000000000
00000000000111111100000010001000000000000000000000000000000000000000000000000000
00000000001111111111100011001001100000000000000000000000000000000000000000000000
00000000011101111111110011111111000000000000000000000000000000000000000000000000
00000000011000111110110001111110000000000000000000000000000000000000000000000000
00000000000001111100001001001110000011111111100000000000000000000000000000000000
00000000000011001000001111000111000111000000110000000000000000000000000000000000
00000000000111111001111111000011000111000000000000000000000000000000000000000000
00011110111100111101111111100111101110111100000000000000000000000000000000000000
00000011111000011111111001111100011101100000000000000000000000000000000000000000
00000001110000000111111000111000001111000000000000000000000000000000000000000000
00000000000000000111101100111000000111000000000000000000000000000000000000000000
00000000000000111111110111100110000100000000000000000000000000000000000000000000
00000000000000111111110111100010000100000000000000000000000000000000000000000000
00000000000000111111110011000011000110000000000000000000000000000000000000000000
00000000000000000011111110000111111110000000000000000000000000000000000000000000
00000000000100000111111110000111100111000000000000000000000000000000000000000000
00001100000111111111211111001111000111100000000000000000000000000000000000000000
00001110011111111111111111111111000100000000000000000000000000000000000000000000
00000111110011111111111101111110001100000000000000000000000000000000000000000000
00000011111111111111111111111110001000000000000000000000000000000000000000000000
00000011111111111000111111100000001000000000000000000000000000000000000000000000
00000011111100110000110011110111101100000000000000000000000000000000000000000000
00000110111100111001110011111111100100000000000000000000000000000000000000000000
00000000111110011001110011111111100100000000000000000000000000000000000000000000
00000000100000011000111111110000110110000000000000000000000000000000000000000000
00000000100001111110111111100001111111111000000000000000000000000000000000000000
00000000110011111111111111110011001100001000000000000000000000000000000000000000
00000000111111111111111111110010001100001000000000000000000000000000000000000000
00000000000111111111111111110110001100001000000000000000000000000000000000000000
00000000000011111111000011111111111000011000000000000000000000000000000000000000
00000000000001111111100001111111110000000000000000000000000000000000000000000000
00000000000000000000000000000000000000000000000000000000000000000000000000000000
