80 80
00000000000000000000000000000000000000000000000000000000000000000000000000000000
00000000000000000000000000000000000000000000000000000000000000000000000000000000
00000000000000000000000000000000000000000000000000000000000000000000000000000000
00000000000000000000000000000000000000000000000000000000000000000000000000000000
00000000000000000000000010000000000000000000000000000000000000000000000000000000
00000000000000000000000111100000000110000000000000000000000000000000000000000000
00000000000000000000001110110000000011110000000000000000000000000000000000000000
00000000000000000000001100011000001111100000000000000000000000000000000000000000
00000000000000000000011100001100001100000000000000000000000000000000000000000000
00000000000000011000111110001110001000000000000000000000000000000000000000000000
00000000000000111101110111110111011110000000000000000000000000000000000000000000
00000000000001111111100001110011110011000000000000000000000000000000000000000000
00000000000001100011100000000111111111000000000000000000000000000000000000000000
00000000000000100011101110000000001110000000000000000000000000000000000000000000
00000000000000111011100011000001000110000000000000000000000000000000000000000000
00000000000000111001110001000111111100000000000000000000000000000000000000000000
00000000000000111000110001101100011000000000000000000000000000000000000000000000
00000000000000111001110001111000000000000000000000000000000000000000000000000000
00000000000000011111110000111100000000000000000000000000000000000000000000000000
00000000000000111111100001110111100000000000000000000000000000000000000000000000
00000000000000111001110011100111100000000000000000000000000000000000000000000000
00000000000000011000111111000111100000000000000000000000000000000000000000000000
00000000000000001000111111100111100000000000000000000000000000000000000000000000
00000000000000000001111111111111100000000000000000000000000000000000000000000000
00000000000000000001111111112111000100000000000000000000000000000000000000000000
00000000000000000000111111111111101100000000000000000000000000000000000000000000
00000000000000000001110011000111111100000000000000000000000000000000000000000000
00000000000000000000010000000111111000000000000000000000000000000000000000000000
00000000000000000000011110000011000000000000000000000000000000000000000000000000
00000000000000000000110011000011000000000000000000000000000000000000000000000000
00000000000000000000100001000111000000000000000000000000000000000000000000000000
00000000000000000001100001100100000000000000000000000000000000000000000000000000
00000000000000000001000011100000000000000000000000000000000000000000000000000000
00000000000000000001000111111000110000000000000000000000000000000000000000000000
00000000000000000001101101111100011000000000000000000000000000000000000000000000
00000000000000000000111111100111111100000000000000000000000000000000000000000000
00000000000000000000111111000000100000000000000000000000000000000000000000000000
00000000000000000000011111100000100000000000000000000000000000000000000000000000
00000000000000000000011011100000000000000000000000000000000000000000000000000000
00000000000000000000111111110000000000000000000000000000000000000000000000000000
00000000000000000000111111111110000000000000000000000000000000000000000000000000
00000000000000000000111100011100000000000000000000000000000000000000000000000000
00000000000000000001111000001000000000000000000000000000000000000000000000000000
00000000000000000000110000000000000000000000000000000000000000000000000000000000
00000000000000000000110000000000000000000000000000000000000000000000000000000000
00000000000000000000100000000000000000000000000000000000000000000000000000000000
00000000000000000001100000000000000000000000000000000000000000000000000000000000
00000000000000000011000000000000000000000000000000000000000000000000000000000000
00000000000000000000000000000000000000000000000000000000000000000000000000000000
00000000000000000000000000000000000000000000000000000000000000000000000000000000
00000000000000000000000000000000000000000000000000000000000000000000000000000000
00000000000000000000000000000000000000000000000000000000000000000000000000000000
00000000000000000000000000000000000000000000000000000000000000000000000000000000
00000000000000000000000000000000000000000000000000000000000000000000000000000000
00000000000000000000000000000000000000000000000000000000000000000000000000000000
00000000000000000000000000000000000000000000000000000000000000000000000000000000
00000000000000000000000000000000000000000000000000000000000000000000000000000000
00000000000000000000000000000000000000000000000000000000000000000000000000000000
00000000000000000000000000000000000000000000000000000000000000000000000000000000
00000000000000000000000000000000000000000000000000000000000000000000000000000000
00000000000000000000000000000000000000000000000000000000000000000000000000000000
00000000000000000000000000000000000000000000000000000000000000000000000000000000
00000000000000000000000000000000000000000000000000000000000000000000000000000000
00000000000000000000000000000000000000000000000000000000000000000000000000000000
00000000000000000000000000000000000000000000000000000000000000000000000000000000
00000000000000000000000000000000000000000000000000000000000000000000000000000000
00000000000000000000000000000000000000000000000000000000000000000000000000000000
00000000000000000000000000000000000000000000000000000000000000000000000000000000
00000000000000000000000000000000000000000000000000000000000000000000000000000000
00000000000000000000000000000000000000000000000000000000000000000000000000000000
00000000000000000000000000000000000000000000000000000000000000000000000000000000
00000000000000000000000000000000000000000000000000000000000000000000000000000000
00000000000000000000000000000000000000000000000000000000000000000000000000000000
00000000000000000000000000000000000000000000000000000000000000000000000000000000
00000000000000000000000000000000000000000000000000000000000000000000000000000000
00000000000000000000000000000000000000000000000000000000000000000000000000000000
00000000000000000000000000000000000000000000000000000000000000000000000000000000
00000000000000000000000000000000000000000000000000000000000000000000000000000000
00000000000000000000000000000000000000000000000000000000000000000000000000000000
00000000000000000000000000000000000000000000000000000000000000000000000000000000
