80 80
00000000000000000000000000000000000000000000000000000000000000000000000000000000
00000000000000000000000000000000000000000000000000000000000000000000000000000000
00000000000000000000000000000000000000000000000000000000000000000000000000000000
00000000000000000000000000000000000000000000000000000000000000000000000000000000
00000000000000000000000000000000000000000000000000000000000000000000000000000000
00000000000000000000000000000000000000000000000000000000000000000000000000000000
00000000000000000000000000000000000000000000000000000000000000000000000000000000
00000000000000000000000000000000000000000000000000000000000000000000000000000000
00000000000000000000000000000000000000000000000000000000000000000000000000000000
00000000000000000000000000000000000000000000000000000000000000000000000000000000
00000000000000000000000000000000000000000000000000000000000000000000000000000000
00000000000000000000000000000000000000000000000000000000000000000000000000000000
00000000000000000000000000000000000000000000000000000000000000000000000000000000
00000000000000000000000000000000000000000000000000000000000000000000000000000000
00000000000000000000000000000000000000000000000000000000000000000000000000000000
00000000000000000000000000000000000000000000000000000000000000000000000000000000
00000000000000000000000000000000000000000000000000000000000000000000000000000000
00000000000000000000000000000000000000000000000000000000000000000000000000000000
00000000000000000000000000000000000000000000000000000000000000000000000000000000
00000000000000000000000000000000000000000000000000000000000000000000000000000000
00000000000000000000000000000000000000000000000000000000000000000000000000000000
00000000000000000000000000000000000000000000000000000000000000000000000000000000
00000000000000000000000000000000000000000000000000000000000000000000000000000000
00000000000000000000000000000000000000000000000000000000000000000000000000000000
00000000000000000000000000000000000000000000000000000000000000000000011000000000
00000000000000000000000000000000000000000000000000000000000000000000001001111100
00000000000000000000000000000000000000000000000000000000000000000000001111111110
00000000000000000000000000000000000000000000000000000000000000000000000110011110
00000000000000000000000000000000000000000000000000000000000000000000011100111000
00000000000000000000000000000000000000000000000000000000110111000100011100110000
00000000000000000000000000000000000000000000000000000011101111000100011100111000
00000000000000000000000000000000000000000000000000000111001111000100011100011010
00000000000000000000000000000000000000000000000000000110000111111100011111111110
00000000000000000000000000000000000000000000000000000011000011111100011111111110
00000000000000000000000000000000000000000000000000000011000011111111111100111110
00000000000000000000000000000000000000000000000000000011100011111111111100111110
00000000000000000000000000000000000000000000000000000111000110111111111100111110
00000000000000000000000000000000000000000000000000000011000111110112111000011110
00000000000000000000000000000000000000000000000000000110001110000111110000011000
00000000000000000000000000000000000000000000000000100011111110001111111000011000
00000000000000000000000000000000000000000000000001110011100010001111111100111000
00000000000000000000000000000000000000000000000001100111100011000111001100110000
00000000000000000000000000000000000000000000000011111111100000000110000000000000
00000000000000000000000000000000000000000000000011110100000000001110000000000000
00000000000000000000000000000000000000000000000000100000000000011110001110011100
00000000000000000000000000000000000000000000000000100000000000111110011111111110
00000000000000000000000000000000000000000000000000100000000000111111111001110100
00000000000000000000000000000000000000000000000000000000000000011001110000000100
00000000000000000000000000000000000000000000000000000000000000000001110000000110
00000000000000000000000000000000000000000000000000000000000000001111111100011110
00000000000000000000000000000000000000000000000000000000000111111111111100111110
00000000000000000000000000000000000000000000000000000000000000011111111111111110
00000000000000000000000000000000000000000000000000000000000000011111111111110010
00000000000000000000000000000000000000000000000000000000000000111100011111110000
00000000000000000000000000000000000000000000000000000000000000111100011111110000
00000000000000000000000000000000000000000000000000000000000000001100011111111000
00000000000000000000000000000000000000000000000000000000000000000110001111111000
00000000000000000000000000000000000000000000000000000000000000001110000111111100
00000000000000000000000000000000000000000000000000000000000000011110000111111110
00000000000000000000000000000000000000000000000000000000000000011111001111111110
00000000000000000000000000000000000000000000000000000000000000011111111111111010
00000000000000000000000000000000000000000000000000000000000000111111111111111000
00000000000000000000000000000000000000000000000000000000000000110000111111110000
00000000000000000000000000000000000000000000000000000000000000100001111111000000
00000000000000000000000000000000000000000000000000000000000000000011111110111000
00000000000000000000000000000000000000000000000000000000000000001111111111111100
00000000000000000000000000000000000000000000000000000000000000001101110111111110
00000000000000000000000000000000000000000000000000000000000000000000100000000110
00000000000000000000000000000000000000000000000000000000000000000000000000000010
00000000000000000000000000000000000000000000000000000000000000000000000000000010
00000000000000000000000000000000000000000000000000000000000000000000000000000000
00000000000000000000000000000000000000000000000000000000000000000000000000000000
00000000000000000000000000000000000000000000000000000000000000000000000000000000
00000000000000000000000000000000000000000000000000000000000000000000000000000000
00000000000000000000000000000000000000000000000000000000000000000000000000000000
00000000000000000000000000000000000000000000000000000000000000000000000000000000
00000000000000000000000000000000000000000000000000000000000000000000000000000000
00000000000000000000000000000000000000000000000000000000000000000000000000000000
00000000000000000000000000000000000000000000000000000000000000000000000000000000
00000000000000000000000000000000000000000000000000000000000000000000000000000000
