80 80
00000000000000000000000000000000000000000000000000000000000000000000000000000000
00000000000000000000000000000000000000000000000000000000000000000000000000000000
00000000000000000000000000000000000000000000000000000000000000000000000000000000
00000000000000000000000000000000000000000000000000000000000000000000000000000000
00000000000000000000000000000000000000000000000000000000000000000000000000000000
00000000000000000000000000000000000000000000000000000000000000000000000000000000
00000000000000000000000000000000000000000000000000000000000000000000000000000000
00000000000000000000000000000000000000000000000000000000000000000000000000000000
00000000000000000000000000000000000000000000000000000000000000000000000000000000
00000000000000000000000000000000000000000000000000000000000000000000000000000000
00000000000000000000000000000000000000000000000000000000000000000000000000000000
00000000000000000000000000000000000000000000000000000000000000000000000000000000
00000000000000000000000000000000000000000000000000000000000000000000000000000000
00000000000000000000000000000000000000000000000000000000000000000000000000000000
00000000000000000000000000000000000000000000000000000000000000000000000000000000
00000000000000000000000000000000000000000000000000000000000000000000000000000000
00000000000000000000000000000000000000000000000000000000000000000000000000000000
00000000000000000000000000000000000000000000000000000000000000000000000000000000
00000000000000000000000000000000000000000000000000000000000000000000000000000000
00000000000000000000000000000000000000000000000000000000000000000000000000000000
00000000000000000000000000000000000000000000000000000000000000000000000000000000
00000000000000000000000000000000000000000000000000000000000000000000000000000000
00000000000000000000000000000000000000000000000000000000000000000000000000000000
00000000000000000000000000000000000000000000000000000000000000000000000000000000
00000000000000000000000000000000000000000000000000000000000000000000000000000000
00000000000000000000000000000000000000000000000000000000000000000000000000000000
00000000000000000000000000000000000000000000000000000000000000000000000000000000
00000000000000000000000000000000000000000000000000000000000000000000000000000000
00000000000000000000000000000000000000000000000000000000000000000000000000000000
00000000000000000000000000000000000000000000000000000000000000000000000000000000
00000000000000000000000000000000000000000000000000000000000000000000000000000000
00000000000000000000000000000000000000000000000000000000000000000000000000000000
00000000000000000000000000000000000000000000000000000000000000000000000000000000
00000000000000000000000000000000000000000000000000000000000000000000000000000000
00000000000000000000000000000010000000000000000000000000000000000000000000000000
00000000000000000000000000000010000000000000000000000000000000000000000000000000
00000000000000000000000000000010000000000000000000000000000000000000000000000000
00000000000000000010000000000010000000000000000000000000000000000000000000000000
00000000000000111110000000000011100000000000000000000000000000000000000000000000
00000000000000111111110000000111000000000000000000000000000000000000000000000000
00000000000000111111110000000111000000000000000000000000000000000000000000000000
00000000000000010011110000000011000000000000000000000000000000000000000000000000
00000000000000110000000000000111110000000000000000000000000000000000000000000000
00000000010011110000000000001111100000000000000000000000000000000000000000000000
00000000011111111111000111011110000000000000000000000000000000000000000000000000
00000000011111111111111111111111000000000000000000000000000000000000000000000000
00000000001111111000111001111011100000000000000000000000000000000000000000000000
00000001000011100000000000010011100000000000000000000000000000000000000000000000
00000001000001100000000000111111100000000000000000000000000000000000000000000000
00110011100000110111100001111111111000011000000011000000000000000000000000000000
00011111111110111111111011111111111111111100111111100000000000000000000000000000
00000000100111011111111111111111110111111110000000111000000000000000000000000000
00000000100011000000011111111000011111111110000011111000000000000000000000000000
00000000100001000000011111111000011111111110000000111100000000000000000000000000
00000000010001110111111111111011111101011111110000111111000010000000000000000000
00000000011100111111111111111111111111011111111001111111110010000000000000000000
00000000000110011111111111111111111111111011111001100111110011000000000000000000
00000000000011001111111111111110111111111001111111000111100011100000000000000000
00000000000001100111111111111111111110010000111111100111000111000000000000000000
00000000000001111111111111100111111110011100111111111111000011000000000000000000
00000000011111111111111111100111111111111111111111111111110111000000000000000000
00000000011111111111111111111111111111111111111111111111111110000000000000000000
00000000000011111111111101111111110011111111111111111101111110000000000000000000
00000000000000111111111111111111110011111101111111111111111000000000000000000000
00000000000000011111111111101111111111111100111111111111111011111000010000000000
00000000000000111111111111111111111111111100111111111011111111111111111100000000
00000000000000110111111111110111111111111100111111110011111111111111100110000000
00000000000000010001101111110001111111111111111111111111111111111111100000000000
00000000000000000000001111111001111111111111111111111111111111111101000000000000
00000000000000000000111111111111111111111121111111111111111111111111100000111000
00000000000000000001111111111111111111111111111111111111111111111111111111111000
00000000000000000001111111111111111111111111111111111111111111111001100011111010
00000000000000000000111011111111110001111111111111111100110000100000100001100010
00000000000000000000110011111111110000111111111111111100110000100000111000100010
00000000000000000000100011101111111110111111111111111111110011111001111000110010
00000000000000000000100001101111111111011111111111111111110111111111011000011010
00000000000000001000110001100111101111011111111111111111111111110010001100011110
00000000000000001101110001100011100011001111111111111111111110100000000000001100
00000000000000001111110011000111100011001110011111111111111111100000000000001100
00000000000000000000000000000000000000000000000000000000000000000000000000000000
