80 80
00000000000000000000000000000000000000000000000000000000000000000000000000000000
00000000000000000000000000000000000000000000000000000000000000000000000000000000
00000000000000000000000000000000000000000000000000000000000000000000000000000000
00000000000000000000000000000000000000000000000000000000000000000000000000000000
00000000000000000000000000000000000000000000000000000000000000000000000000000000
00000000000000000000000000000000000000000000000000000000000000000000000000000000
00000000000000000000000000000000000000000000000000000000000000000000000000000000
00000000000000000000000000000000000000000000000000000000000000000000000000000000
00000000000000000000000000000000000000000000000000000000000000000000000000000000
00000000000000000000000000000000000000000000000000000000000000000000000000000000
00000000000000000000000000000000000000000000000000000000000000000000000000000000
00000000000000000000000000000000000000000000000000000000000000000000000000000000
00000000000000000000000000000000000000000000000000000000000000000000000000000000
00000000000000000000000000000000000000000000000000000000000000000000000000000000
00000000000000000000000000000000000000000000000000000000000000000000000000000000
00000000000000000000000000000000000000000000000000000000000000000000000000000000
00000000000000000000000000000000000000000000000000000000000000000000000000000000
00000000000000000000000000000000000000000000000000000000000000000000000000000000
00000000000000000000000000000000000000000000000000000000000000000000000000000000
00000000000000000000000000000000000000000000000000000000000000000000000000000000
00000000000000000000000000000000000000000000000000000000000000000000000000000000
00000000000000000000000000000000000000000000000000000000000000000000000000000000
00000000000000000000000000000000000000000000000000000000000000000000000000000000
00000000000000000000000000000000000000000000000000000000000000000000000000000000
00000000000000000000000000000000000000000000000000000000000000000000000000000000
00000000000000000000000000000000000000000000000000000000000000000000000000000000
00000000000000000000000000000000000000000000000000000000000000000000000000000000
00000000000000000000000000000000000000000000000000000000000000000000000000000000
00000000000000000000000000000000000000000000000000000000000000000000000000000000
00000000000000000000000000000000000000000000000000000000000000000000000000000000
00000000000000000000000000000000000000000000000000000000000000000000000000000000
00000000000000000000000000000000000000000000000000000000000000000000000000000000
00000000000000000000000000000000000000000000000000000000000000000000000000000000
00000000000000000000000000000000000000000000000000000000000000000000000000000000
00000000000000000000000000000000000000000000000000000000000000000000000000000000
00000000000000000000000000000000000000000000000000000000000000000000000000000000
00000000000000000000000000000000000000000000000000000000000000000000000000000000
00000000000000000000000000000000000000000000000000000000000000000000000000000000
00000000000000000000000000000000000000000000000000000000000000000000000000000000
00000000000000000000000000000000000000000000000000000000000000000000000000000000
00000000000000000000000000000000000000000000000000000000000000000000000000000000
00000000000000000000000000000000000000000000000000000000000000000000000000000000
00000000000000000000000000000000000000000000000000000000000000000000000000000000
00000000000000000000000000000000000000000000000000000011000000000000000000000000
00000000000000000000000000000000000000000000000000000001000000000000000000000000
00000000000000000000000000000000000000000000000000000001000000000000000000000000
00000000000000000000000000000000000000000000000000000001000000000000000000000000
00000000000000000000000000000000000000000000000000000001110000000000000000000000
00000000000000000000000000000000000000000000000000000000111000000000000000000000
00000000000000000000000000000000000000000000000000000000011110000000000000000000
00000000000000000000000000000000000000000000000000000000000110000000000000000000
00000000000000000000000000000000000000000000000000000000000011000000000000000000
00000000000000000000000000000000000000000000000000000000001111100000000000000000
00000000000000000000000000000000000001000000001000000000111110110000000000000000
00000000000000000000000000000000000011111000011000110001100110010000111100111110
00000000000000000000000000000000000001111111111011111011000010001111111111111110
00000000000000000000000000000000000000101111110001111111000011000011110111111000
00000000000000000000000000000000000000000111100000001111110011000011000001111000
00000000000000000000000000000000000000000111100000001111111010111111000000110000
00000000000000000000000000000000000000001111110001111111000110111110000000110000
00000000000000000000000000000000000000011111111011111111100011111110000000111000
00000000000000000000000000000000000000011111111111111101100011101110000000011110
00000000000000000000000000000000000000011110001111111111100011111110000000011000
00000000000000000000000000000000011111111100000111121111110111000111000000001000
00000000000000000000000000001110011111111100111111111111111111000110000000000000
00000000000000000000000000000011011111111111111111111111111111000100000000000000
00000000000000000000000000000011111001111111111111111111111111000000000000000000
00000000000000000000000000000000110001111111111111101111110001100000000000000000
00000000000000000000000000000000010000111111111111001111110001000000000000000000
00000000000000000000000000000000000111111111111111101111010001000000000000000000
00000000000000000000000000000011111111111111111111111111111000000000000000000000
00000000000000000000000000000000011100000000011110111101111100000000000000000000
00000000000000000000000000000000000000000000000010101000110000000000000000000000
00000000000000000000000000000000000000000000000011001000110000000000000000000000
00000000000000000000000000000000000000000000000001001000100000000000000000000000
00000000000000000000000000000000000000000000000001111011000000000000000000000000
00000000000000000000000000000000000000000000000000111110000000000000000000000000
00000000000000000000000000000000000000000000000000111000000000000000000000000000
00000000000000000000000000000000000000000000000000101000000000000000000000000000
00000000000000000000000000000000000000000000000000000000000000000000000000000000
