80 80
00000000000000000000000000000000000000000000000000000000000000000000000000000000
00000000001111111111110111110000000000000000000000000000000000000000000000000000
00010000000011111111110011110000000000000000000000000000000000000000000000000000
00010000000001111101110001110000000000000000000000000000000000000000000000000000
00010011111001111000110001111110000000000000000000000000000000000000000000000000
00011111111111111101110011111111000000000000000000000000000000000000000000000000
01111100001111111111100111011111000000000000000000000000000000000000000000000000
01111000000111000111100110011111000000000000000000000000000000000000000000000000
00011100001111011111111000011100000000000000000000000000000000000000000000000000
00111110011111111111111001111100000000000000000000000000000000000000000000000000
01111110011111211111111011100111000000000000000000000000000000000000000000000000
00111110111111111111111111000000000000000000000000000000000000000000000000000000
00011111110001100111111111000000000000000000000000000000000000000000000000000000
00001111000001000111001001000000000000000000000000000000000000000000000000000000
00001100111011111111101001000000000000000000000000000000000000000000000000000000
00001111111111111111111001000000000000000000000000000000000000000000000000000000
00000111111111111110010011000000000000000000000000000000000000000000000000000000
00000011110001100110000010000000000000000000000000000000000000000000000000000000
00000010111000111110000011000000000000000000000000000000000000000000000000000000
00000110001000011111000001000000000000000000000000000000000000000000000000000000
00001110001000111001110001000000000000000000000000000000000000000000000000000000
00001100011000110000011001000000000000000000000000000000000000000000000000000000
00011110011000100000001110000000000000000000000000000000000000000000000000000000
00111001111000100000000100000000000000000000000000000000000000000000000000000000
01111111111000110000001110000000000000000000000000000000000000000000000000000000
01001111011000011001111111111111100000000000000000000000000000000000000000000000
00000110001100011111000000110000000000000000000000000000000000000000000000000000
00000011011100000000000000000000000000000000000000000000000000000000000000000000
00000011111110000000000000000000000000000000000000000000000000000000000000000000
00000110011100000000000000000000000000000000000000000000000000000000000000000000
00000100011100000000000000000000000000000000000000000000000000000000000000000000
00001100011100000000000000000000000000000000000000000000000000000000000000000000
00001100011000000000000000000000000000000000000000000000000000000000000000000000
00001000000000000000000000000000000000000000000000000000000000000000000000000000
00001100001000000000000000000000000000000000000000000000000000000000000000000000
00001110011000000000000000000000000000000000000000000000000000000000000000000000
00000111001100000000000000000000000000000000000000000000000000000000000000000000
00000001111100000000000000000000000000000000000000000000000000000000000000000000
00000000111000000000000000000000000000000000000000000000000000000000000000000000
00000000010000000000000000000000000000000000000000000000000000000000000000000000
00000000000000000000000000000000000000000000000000000000000000000000000000000000
00000000000000000000000000000000000000000000000000000000000000000000000000000000
00000000000000000000000000000000000000000000000000000000000000000000000000000000
00000000000000000000000000000000000000000000000000000000000000000000000000000000
00000000000000000000000000000000000000000000000000000000000000000000000000000000
00000000000000000000000000000000000000000000000000000000000000000000000000000000
00000000000000000000000000000000000000000000000000000000000000000000000000000000
00000000000000000000000000000000000000000000000000000000000000000000000000000000
00000000000000000000000000000000000000000000000000000000000000000000000000000000
00000000000000000000000000000000000000000000000000000000000000000000000000000000
00000000000000000000000000000000000000000000000000000000000000000000000000000000
00000000000000000000000000000000000000000000000000000000000000000000000000000000
00000000000000000000000000000000000000000000000000000000000000000000000000000000
00000000000000000000000000000000000000000000000000000000000000000000000000000000
00000000000000000000000000000000000000000000000000000000000000000000000000000000
00000000000000000000000000000000000000000000000000000000000000000000000000000000
00000000000000000000000000000000000000000000000000000000000000000000000000000000
00000000000000000000000000000000000000000000000000000000000000000000000000000000
00000000000000000000000000000000000000000000000000000000000000000000000000000000
00000000000000000000000000000000000000000000000000000000000000000000000000000000
00000000000000000000000000000000000000000000000000000000000000000000000000000000
00000000000000000000000000000000000000000000000000000000000000000000000000000000
00000000000000000000000000000000000000000000000000000000000000000000000000000000
00000000000000000000000000000000000000000000000000000000000000000000000000000000
00000000000000000000000000000000000000000000000000000000000000000000000000000000
00000000000000000000000000000000000000000000000000000000000000000000000000000000
00000000000000000000000000000000000000000000000000000000000000000000000000000000
00000000000000000000000000000000000000000000000000000000000000000000000000000000
00000000000000000000000000000000000000000000000000000000000000000000000000000000
00000000000000000000000000000000000000000000000000000000000000000000000000000000
00000000000000000000000000000000000000000000000000000000000000000000000000000000
00000000000000000000000000000000000000000000000000000000000000000000000000000000
00000000000000000000000000000000000000000000000000000000000000000000000000000000
00000000000000000000000000000000000000000000000000000000000000000000000000000000
00000000000000000000000000000000000000000000000000000000000000000000000000000000
00000000000000000000000000000000000000000000000000000000000000000000000000000000
00000000000000000000000000000000000000000000000000000000000000000000000000000000
00000000000000000000000000000000000000000000000000000000000000000000000000000000
00000000000000000000000000000000000000000000000000000000000000000000000000000000
00000000000000000000000000000000000000000000000000000000000000000000000000000000
