80 80
00000000000000000000000000000000000000000000000000000000000000000000000000000000
00000000000000000000000000000000000000000000000000000000000000000000000000000000
00000000000000000000000000000000000000000000000000000000000000000000000000000000
00000000000000000000000000000000000000000000000000000000000000000000000000000000
00000000000000000000000000000000000000000000000000000000000000000000000000000000
00000000000000000000000000000000000000000000000000000000000000000000000000000000
00000000000000000000000000000000000000000000000000000000000000000000000000000000
00000000000000000000000000000000000000000000000000000000000000000000000000000000
00000000000000000000000000000000000000000000000000000000000000000000000000000000
00000000000000000000000000000000000000000000000000000000000000000000000000000000
00000000000000000000000000000000000000000000000000000000000000000000000000000000
00000000000000000000000000000000000000000000000000000000000000000000000000000000
00000000000000000000000000000000000000000000000000000000000000000000000000000000
00000000000000000000000000000000000000000000000000000000000000000000000000000000
00000000000000000000000000000000000000000000000000000000000000000000000000000000
00000000000000000000000000000000000000000000000000000000000000000000000000000000
00000000000000000000000000000000000000000000000000000000000000000000000000000000
00000000000000000000000000000000000000000000000000000000000000000000000000000000
00000000000000000000000000000000000000000000000000000000000000000000000000000000
00000000000000000000000000000000000000000000000000000000000000000000000000000000
00000000000000000000000000000000000000000000000000000000000000000000000000000000
00000000000000000000000000000000000000000000000000000000000000000000000000000000
00000000000000000000000000000000000000000000000000000000000000000000000000000000
00000000000000000000000000000000000000000000000000000000000000000000000000000000
00000000000000000000000000000000000000000000000000000000000000000000000000000000
00000000000000000000000000000000000000000000000000000000000000000000000000000000
00000000000000000000000000000000000000000000000000000000000000000000000000000000
00000000000000000000000000000000000000000000000000000000000000000000000000000000
00000000000000000000000000000000000000000000000000000000000000000000000000000000
00000000000000000000000000000000000000000000000000000000000000000000000000000000
00000000000000000000000000000000000000000000000000000000000000000000000000000000
00000000000000000000000000000000000000000000000000000000000000000000000000000000
00000000000000000000001100000000000000000000000000000000000000000000000000000000
00110111000000000000001111100000000000000000000000000000000000000000000000000000
01111111111000000000011111100000000000000000000000000000000000000000000000000000
01001111111100000001111111100000000000000000000000000000000000000000000000000000
00000111001110000001100011100000000000000000000000000000000000000000000000000000
00001110000110000001100000100000000000000000000000000000000000000000000000000000
01111110011100001001110000000000000000000000000000000000000000000000000000000000
01111111101100011011111000000000000000000000000000000000000000000000000000000000
01011111111110111001110000000000000000000000000000000000000000000000000000000000
00001111110011110001110000000000000000000000000000000000000000000000000000000000
00001111100001110011110000000000000000000000000000000000000000000000000000000000
00111111100001110110111000000000000000000000000000000000000000000000000000000000
01110101111000011110111001110000000000000000000000000000000000000000000000000000
01111110011110011011111111100000000000000000000000000000000000000000000000000000
01100000001111110001000110000000000000000000000000000000000000000000000000000000
00000000000111110000000100000000000000000000000000000000000000000000000000000000
00000000000111110000001000000000000000000000000000000000000000000000000000000000
00000000001011110000011000000000000000000000000000000000000000000000000000000000
00000000001111110001111111100000000000000000000000000000000000000000000000000000
00000000001001011001101100000000000000000000000000000000000000000000000000000000
00000000100000011111111000000000000000000000000000000000000000000000000000000000
00000000110000111111111000000000000000000000000000000000000000000000000000000000
00000000111001110011111000000000000000000000000000000000000000000000000000000000
00000000001011111011111111110000000000000000000000000000000000000000000000000000
00000000001111011111111110010000000000000000000000000000000000000000000000000000
00000000000110001111100000110000000000000000000000000000000000000000000000000000
00000000000000011111100001100000000000000000000000000000000000000000000000000000
00000000000000011000100001000000000000000000000000000000000000000000000000000000
00000000000000010000100001100000000000000000000000000000000000000000000000000000
00000000000000000000100001000000000000000000000000000000000000000000000000000000
00000000000000000000000001000000000000000000000000000000000000000000000000000000
00000000000000000000000011000000000000000000000000000000000000000000000000000000
00000000000000000000000001000000000000000000000000000000000000000000000000000000
00000000000000000000000001000010000000000000000000000000000000000000000000000000
00000000000000000000000001000110000000000000000000000000000000000000000000000000
00000000000000000000000001101110000000000000000000000000000000000000000000000000
00000000000000000000110111111111000000000000000000000000000000000000000000000000
00000000000000001100111111121011110000000000000000000000000000000000000000000000
00000000000000011111110011111111011111000000000000000000000000000000000000000000
00000000000000000001000001111110000000000000000000000000000000000000000000000000
00000000000000000000000000110000000000000000000000000000000000000000000000000000
00000000000000000000000000000000000000000000000000000000000000000000000000000000
00000000000000000000000000000000000000000000000000000000000000000000000000000000
00000000000000000000000000000000000000000000000000000000000000000000000000000000
00000000000000000000000000000000000000000000000000000000000000000000000000000000
00000000000000000000000000000000000000000000000000000000000000000000000000000000
00000000000000000000000000000000000000000000000000000000000000000000000000000000
00000000000000000000000000000000000000000000000000000000000000000000000000000000
