80 80
00000000000000000000000000000000000000000000000000000000000000000000000000000000
00000000000000000000000000000000000000000000001101111101111110111111110100011000
00000000000000000000000000000000000000000000000111111101111100011111100110010000
00000000000000000000000000000000000000000000000111001100111100001111111111110000
00000000000000000000000000000000000000000000011111111111110110001110111101110000
00000000000000000000000000000000000000000000111111110111100111001110011111111000
00000000000000000000000000000000000000000000011101110111000111001110001111101110
00000000000000000000000000000000000000000000000000111110000111111110000000000000
00000000000000000000000000000000010000000100000001111110001111111111000000000000
00000000000000000000000000000000011100000110011111111111011111000111100000000000
00000000000000000000000000000000001110011111111111111111111111001110111100000000
00000000000000000000000000000000000111110011111111111121111111001100011110000000
00000000000000000000000000000000000011110011001101111111111111001100001110000000
00000000000000000000000000000000000011111110111000111111110011011100011100000000
00000000000000000000000000000000000011111100110000110011111111111100011000000000
00000000000000000000000000000000000000111100010001110011111111111100011101111000
00000000000000000000000000000000000000110100011001110011111111110110001111100000
00000000000000000000000000000000000000100000001000111111110001111110001110000000
00000000000000000000000000000000000000100000011100011111110011111111111100000000
00000000000000000000000000000000000000100011011111111111110011011110011000000000
00000000000000000000000000000000000000011111111111111111110010001110001000000000
00000000000000000000000000000000000000000011110000111111110110001110001000000000
00000000000000000000000000000000000000000001111100000011111111111100011000000000
00000000000000000000000000000000000000000000011111000001111111110000001000000000
00000000000000000000000000000000000000000000001001100001111110000000001100000000
00000000000000000000000000000000000000000000111000100001111110000000001000000000
00000000000000000000000000000000000000000000000000100011011010000000000000000000
00000000000000000000000000000000000000000000000000000000001111000000000000000000
00000000000000000000000000000000000000000000000000000000000111110000000000000000
00000000000000000000000000000000000000000000000000000000000011111000000000000000
00000000000000000000000000000000000000000000000000000000000011110000000000000000
00000000000000000000000000000000000000000000000000000000000000000000000000000000
00000000000000000000000000000000000000000000000000000000000000000000000000000000
00000000000000000000000000000000000000000000000000000000000000000000000000000000
00000000000000000000000000000000000000000000000000000000000000000000000000000000
00000000000000000000000000000000000000000000000000000000000000000000000000000000
00000000000000000000000000000000000000000000000000000000000000000000000000000000
00000000000000000000000000000000000000000000000000000000000000000000000000000000
00000000000000000000000000000000000000000000000000000000000000000000000000000000
00000000000000000000000000000000000000000000000000000000000000000000000000000000
00000000000000000000000000000000000000000000000000000000000000000000000000000000
00000000000000000000000000000000000000000000000000000000000000000000000000000000
00000000000000000000000000000000000000000000000000000000000000000000000000000000
00000000000000000000000000000000000000000000000000000000000000000000000000000000
00000000000000000000000000000000000000000000000000000000000000000000000000000000
00000000000000000000000000000000000000000000000000000000000000000000000000000000
00000000000000000000000000000000000000000000000000000000000000000000000000000000
00000000000000000000000000000000000000000000000000000000000000000000000000000000
00000000000000000000000000000000000000000000000000000000000000000000000000000000
00000000000000000000000000000000000000000000000000000000000000000000000000000000
00000000000000000000000000000000000000000000000000000000000000000000000000000000
00000000000000000000000000000000000000000000000000000000000000000000000000000000
00000000000000000000000000000000000000000000000000000000000000000000000000000000
00000000000000000000000000000000000000000000000000000000000000000000000000000000
00000000000000000000000000000000000000000000000000000000000000000000000000000000
00000000000000000000000000000000000000000000000000000000000000000000000000000000
00000000000000000000000000000000000000000000000000000000000000000000000000000000
00000000000000000000000000000000000000000000000000000000000000000000000000000000
00000000000000000000000000000000000000000000000000000000000000000000000000000000
00000000000000000000000000000000000000000000000000000000000000000000000000000000
00000000000000000000000000000000000000000000000000000000000000000000000000000000
00000000000000000000000000000000000000000000000000000000000000000000000000000000
00000000000000000000000000000000000000000000000000000000000000000000000000000000
00000000000000000000000000000000000000000000000000000000000000000000000000000000
00000000000000000000000000000000000000000000000000000000000000000000000000000000
00000000000000000000000000000000000000000000000000000000000000000000000000000000
00000000000000000000000000000000000000000000000000000000000000000000000000000000
00000000000000000000000000000000000000000000000000000000000000000000000000000000
00000000000000000000000000000000000000000000000000000000000000000000000000000000
00000000000000000000000000000000000000000000000000000000000000000000000000000000
00000000000000000000000000000000000000000000000000000000000000000000000000000000
00000000000000000000000000000000000000000000000000000000000000000000000000000000
00000000000000000000000000000000000000000000000000000000000000000000000000000000
00000000000000000000000000000000000000000000000000000000000000000000000000000000
00000000000000000000000000000000000000000000000000000000000000000000000000000000
00000000000000000000000000000000000000000000000000000000000000000000000000000000
00000000000000000000000000000000000000000000000000000000000000000000000000000000
00000000000000000000000000000000000000000000000000000000000000000000000000000000
00000000000000000000000000000000000000000000000000000000000000000000000000000000
00000000000000000000000000000000000000000000000000000000000000000000000000000000
