80 80
00000000000000000000000000000000000000000000000000000000000000000000000000000000
00000000000000000000000000000000000000000000000000000000000000000000000000000000
00000000000000000000000000000000000000000000000000000000000000000000000000000000
00000000000000000000000000000000000000000000000000000000000000000000000000000000
00000000000000000000000000000000000000000000000000000000000000000000000000000000
00000000000000000000000000000000000000000000000000000000000000000000000000000000
00000000000000000000000000000000000000000000000000000000000000000000000000000000
00000000000000000000000000000000000000000000000000000000000000000000000000000000
00000000000000000000000000000000000000000000000000000000000000000000000000000000
00000000000000000000000000000000000000000000000000000000000000000000000000000000
00000000000000000000000000000000000000000000000000000000000000000000000000000000
00000000000000000000000000000000000000000000000000000000000000000000000000000000
00000000000000000000000000000000000000000000000000000000000000000000000000000000
00000000000000000000000000000000000000000000000000000000000000000000000000000000
00000000000000000000000000000000000000000000000000000000000000000000000000000000
00000000000000000000000000000000000000000000000000000000000000000000000000000000
00000000000000000000000000000000000000000000000000000000000000000000000000000000
00000000000000000000000000000000000000000000000000000000000000000000000000000000
00000000000000000000000000000000000000000000000000000000000000000000000000000000
00000000000000000000000000000000000000000000000000000000000000000000000000000000
00000000000000000000000000000000000000000000000000000000000000000000000000000000
00000000000000000000000000000000000000000000000000000000000000000000000000000000
00000000000000000000000000000000000000000000000000000000000000000000000000000000
00000000000000000000000000000000000000000000000000000000000000000000000000000000
00000000000000000000000000000000000000000000000000000000000000000000000000000000
00000000000000000000000000000000000000000000000000000000000000000000000000000000
00000000000000000000000000000000000000000000000000000000000000000000000000000000
00000000000000000000000000000000000000000000000000000000000000000000000000000000
00000000000000000000000000000000000000000000000000000000000000000000000000000000
00000000000000000000000000000000000000000000000000000000000000000000000000000000
00000000000000000000000000000000000000000000000000000000000000000000000000000000
00000000000000000000000000000000000000000000000000000000000000000000000000000000
00000000000000000000000000000000000000000000000000000000000000000000000000000000
00000000000000000000000000000000000000000000000000000000000000000000000000000000
00000000000000000000000000000000000000000000000000000000000000000000000000000000
00000000000000000000000000000000000000000000000000000000000000000000000000000000
00000000000000000000000000000000000000000000000000000000000000000000000000000000
00000000000000000000000000000000000000000000000000000000000000000000000000000000
00000000000000000000000000000000000000000000000000000000000000000000000000000000
00000000000000000000000000000000000000000000000000000000000000000000000010000000
00000000000000000000000000000000000000000000000000000000000000000000001110010000
00000000000000000000000000000000000000000000000000000000000000000010001100010000
00000000000000000000000000000000000000000000000000000000000000000010011110010000
00000000000000000000000000000000000000000000000000000000000000000011111111110000
00000000000000000000000000000000000000000000000000000000000000000111011110110000
00000000000000000000000000000000000000000000000000000000000000000100011110010000
00000000000000000000000000000000000000000000000000000000000000001100011100000000
00000000000000000000000000000000000000000000000000000000000000001100111010000000
00000000000000000000000000000000000000000000000000000001000000001111110010000000
00000000000000000000000000000000000000000000000000000011010010000100011111010000
00000000000000000000000000000000000000000000000000000001111110000110111111111000
00000000000000000000000000000000000000000000000000000001110011000111111111111110
00000000000000000000000000000000000000000000000000000001110011000111100110001110
00000000000000000000000000000000000000000000000000001111000100000111110000011110
00000000000000000000000000000000000000000000000000000011011110011111111000010000
00000000000000000000000000000000000000000000000000000001111111011111111100111000
00000000000000000000000000000000000000000000000000000001111111111111111100011000
00000000000000000000000000000000000000000000000000000000000011110000001111111100
00000000000000000000000000000000000000000000000000000000000010110000111111111100
00000000000000000000000000000000000000000000000111100000000110111011111121111000
00000000000000000000000000000000000000000000111100100011100111111111111111111000
00000000000000000000000000000000000000000000000000110000110011111111111111110000
00000000000000000000000000000000000000000000000000011000011110001111000111100000
00000000000000000000000000000000000000000000011100111000000000011110001111000000
00000000000000000000000000000000000000000000011111111111000011111100011001110000
00000000000000000000000000000000000000000000011111111111110111111110011111111000
00000000000000000000000000000000000000000000010111110001111100000110001111111000
00000000000000000000000000000000000000000000110111100000000000010110000111111110
00000000000000000000000000000000000000000000110111001111000000010110000111111110
00000000000000000000000000000000000000000000011111101111000100110110001100011110
00000000000000000000000000000000000000000000010111110001001111111100011100111110
00000000000000000000000000000000000000000000010000110001101011100100011000110000
00000000000000000000000000000000000000000000000000000000110011100000000001011100
00000000000000000000000000000000000000000000000000000000111111100001000001111110
00000000000000000000000000000000000000000000000000000001101111110011110011110000
00000000000000000000000000000000000000000000000000000001001111111111111100110000
00000000000000000000000000000000000000000000000000000001001111110000000000011000
00000000000000000000000000000000000000000000000000000011001011000000000000000000
00000000000000000000000000000000000000000000000000000111111010000000000000000000
00000000000000000000000000000000000000000000000000000000000000000000000000000000
