80 80
00000000000000000000000000000000000000000000000000000000000000000000000000000000
00000000000000000000000000000000000000000000000000000000000000000000000000000000
00000000000000000000000000000000000000000000000000000000000000000000000000000000
00000000000000000000000000000000000000000000000000000000000000000000000000000000
00000000000000000000000000000000000000000000000000000000000000000000000000000000
00000000000000000000000000000000000000000000000000000000000000000000000000000000
00000000000000000000000000000000000000000000000000000000000000000000000000000000
00000000000000000000000000000000000000000000000000000000000000000000000000000000
00000000000000000000000000000000000000000000000000000000000000000000000000000000
00000000000000000000000000000000000000000000000000000000000000000000000000000000
00000000000000000000000000000000000000000000000000000000000000000000000000000000
00000000000000000000000000000000000000000000000000000000000000000000000000000000
00000000000000000000000000000000000000000000000000000000000000000000000000000000
00000000000000000000000000000000000000000000000000000000000000000000000000000000
00000000000000000000000000000000000000000000000000000000000000000000000000000000
00000000000000000000000000000000000000000000000000000000000000000000000000000000
00000000000000000000000000000000000000000000000000000000000000000000000000000000
00000000000000000000000000000000000000000000000000000000000000000000000000000000
00000000000000000000000000000000000000000000000000000000000000000000000000000000
00000000000000000000000000000000000000000000000000000000000000000000000000000000
00000000000000000000000000000000000000000000000000000000000000000000000000000000
00000000000000000000000000000000000000000000000000000000000000000000000000000000
00000000000000000000000000000000000000000000000000000000000000000000000000000000
00000000000000000000000000000000000000000000000000000000000000000000000000000000
00000000000000000000000000000000000000000000000000000000000000000000000000000000
00000000000000000000000000000000000000000000000000000000000000000000000000000000
00000000000000000000000000000000000000000000000000000000000000000000000000000000
00000000000000000000000000000000000000000000000000000000000000000000000000000000
00000000000000000000000000000000000000000000000000000000000000000000000000000000
00000000000000000000000000000000000000000000000000000000000000000000000000000000
00000000000000000000000000000000000000000000000000000000000000000000000000000000
00000000000000000000000000000000000000000000000000000000000000000000000000000000
00000000000000000000000000000000000000000000000000000000000000000000000000000000
00000000000000000000000000000000000000000000000000000000000000000000000000000000
00000000000000000000000000000000000000000000000000000000000000000000000000000000
00000000000000000000000000000000000000000000000000000000000000000000000000000000
00000000000000000000000000000000000000000000000000000000000000000000000000000000
00000000000000000000000000000000000000000000000000000000000000000000000000000000
00000000000000000000000000000000000000000000000000000000000000000000000000000000
00000000000000000000000000000000000000000000000000000000000000000000000000000000
00000000000000000000000000000000000000000000000000000000000000000000000000000000
00000000000000000000000000000000000000000000000000000000000000000000000000000000
00000000000000000000000000000000000000000000000000000000000000000000000000000000
00000000000000000000000000000000000000000000000000000000000000000000000000000000
00000000000000000000000000000000000000000000000000000000000000000000000000000000
00000000000000000000000000000000000000000000000000000000000000000000000000000000
00000000000000000000000000000000000000000000000000000000000000000000000000000000
00000000000000000000000000000000000000000000000000000000000000000000000000000000
00000000000000000000000000000000000000000000000010000000000000000000000000000000
00000000000000000000000000000000000000000000110010000000000000000000000000000000
00000000000000000000000000000000000000000000011111110000000000000000000000000000
00000000000000000000000000000000000000000000011110100000000000000000000000000000
00000000000000000000000000000000100011000000001000011100000000000000000000000000
00000000000000000000000000001000100010000000001000011110000000000000000000000000
00000000000000000000000000011000100110001100111101011111000010000000000000000000
00000000000000000000000011111111101110001000111111111001000010000000000000000000
00000000000000000000000010001111211100011000111110000001100010000000000000000000
00000000000000000000000000001111111100011001100110000000100010000000000000000000
00000000000000000000000000000111100111111101100011100000011111100000000000000000
00000000000000000000000000000111000111111111110001111000111111111000000000000000
00000000000000000000000000000111101110111100111011111111111111011110000000000000
00000000000000000000000000000111101110011100011000111100011011000000000000000000
00000000000000000000000000000001100111100000011111111000010000000000000000000000
00000000000000000000001100000001110001100011111111111000000000000000000000000000
00000000000000000000011111000011111100111111111101110000000000000000000000000000
00000000000000000000111111100111111111111101111100100000000000000000000000000000
00000000000000000000001111111111110010111000111111100000000000000000000000000000
00000000000000000000001100011100110000100000010111000000000000000000000000000000
00000000000000000000001000000000110000100000001111000000000000000000000000000000
00000000000000000000000011100011111100111000011111000000000000000000000000000000
00000000000000000000000001111111111110011100111101100000000000000000000000000000
00000000000000000000000001111100110110001111100000000000000000000000000000000000
00000000000000000000000000111000011111000110000000000000000000000000000000000000
00000000000000000000000000011100001111100100000000000000000000000000000000000000
00000000000000000000000000011110001111111000000000000000000000000000000000000000
00000000000000000000000011111110001111011100000000000000000000000000000000000000
00000000000000000000000000001011000111000100000000000000000000000000000000000000
00000000000000000000000000001011000001000000000000000000000000000000000000000000
00000000000000000000000000001111000000000000000000000000000000000000000000000000
00000000000000000000000000000000000000000000000000000000000000000000000000000000
