80 80
00000000000000000000000000000000000000000000000000000000000000000000000000000000
00000000000000000000000000000000000000000000000000000000000000000000000000000000
00000000000000000000000000000000000000000000000000000000000000000000000000000000
00000000000000000000000000000000000000000000000000000000000000000000000000000000
00000000000000000000000000000000000000000000000000000000000000000000000000000000
00000000000000000000000000000000000000000000000000000000000000000000000000000000
00000000000000000000000000000000000000000000000000000000000000000000000000000000
00000000000000000000000000000000000000000000000000000000000000000000000000000000
00000000000000000000000000000000000000000000000000000000000000000000000000000000
00000000000000000000000000000000000000000000000000000000000000000000000000000000
00000000000000000000000000000000000000000000000000000000000000000000000000000000
00000000000000000000000000000000000000000000000000000000000000000000000000000000
00000000000000000000000000000000000000000000000000000000000000000000000000000000
00000000000000000000000000000000000000000000000000000000000000000000000000000000
00000000000000000000000000000000000000000000000000000000000000000000000000000000
00000000000000000000000000000000000000000000000000000000000000000000000000000000
00000000000000000000000000000000000000000000000000000000000000000000000000000000
00000000000000000000000000000000000000000000000000000000000000000000000000000000
00000000000000000000000000000000000000000000000000000000000000000000000000000000
00000000000000000000000000000000000000000000000000000000000000000000000000000000
00000000000000000000000000000000000000000000000000000000000000000000000000000000
00000000000000000000000000000000000000000000000000000000000000000000000000000000
00000000000000000000000000000000000000000000000000000000000000000000000000000000
00000000000000000000000000000000000000000000000000000000000000000000000000000000
00000000000000000000000000000000000000000000000000000000000000000000000000000000
00000000000000000000000000000000000000000000000000000000000000000000000000000000
00000000000000000000000000000000000000000000000000000000000000000000000000000000
00000000000000000000000000000000000000000000000000000000000000000000000000000000
00000000000000000000000000000000000000000000000000000000000000000000000000000000
00000000000000000000000000000000000000000000000000000000000000000000000000000000
00000000000000000000000000000000000000000000000000000000000000000000000000000000
00000000000000000000000000000000000000000000000000000000000000000000000000000000
00000000000000000000000000000000000000000000000000000000000000000000000000000000
00000000000000000000000000000000000000000000000000000000000000000000000000000000
00000000000000000000000000000000000000000000000000000000000000000000000000000000
00000000000000000000000000000000000000000000000000000000000000000000000000000000
00000000000000000000000000000000000000000000000000000000000000000000000000000000
00000000000000000000000000000000000000000000000000000000000000000000000000000000
00000000000000000000000000000000000000000000000000000000000000000000000000000000
00000000000000000000000000000000000000000000000000000000000000000000000000000000
00000000000000000000000000000000000000000000000000000000000000000000000000000000
00000000000000000000000000000000000000000000000000000000000000000000000000000000
00000000000000000000000000000000000000000000000000000000000000000000000000000000
00000000000000000000000000000000000000000000000000000000000000000000000000000000
00000000000000000000000000000000000000000000000000000000000000000000000000000000
00000000000000000000000000000000000000000000000000000000000000000000000000000000
00000000000000000000000000010000000000000000000000000000000000000000000000000000
00000000000000000000000000010000000000000000000000000000000000000000000000000000
00000000000000000000000000110000000000100000000000000000000000000000000000000000
00000000000000000000100011100000001101111000010000000000000000000000000000000000
00000000001100000000100011111111001111111000011000000000000000000000000000000000
00000000001110000000100011111000000111011100110000000000000000000000000000000000
00000000001110000011101111111000000000111101100000000000000000000000000000000000
00000000001000000001111111001011100000011011100000000000000000000000000000000000
00000000001001000001100011000011111100111001111000000000000000000000000000000000
00000000001101111101110111111111111110111100111000000000000000000000000000000000
00000000001100000111111011111110110111111000111000000000000000000000000000000000
00000000000110000111111111111100010001111000111000000000000000000000000000000000
00000000000011001111111111011100010000110001110000000000000000000000000000000000
00000000001011111111111111111110001100110011110000000000000000000000000000000000
00000000001111111111111111110111001110011110110000000000000000000000000000000000
00000000001001111111111001000011000111000110010000000000000000000000000000000000
00000000000001111111111000000011100011000000010000000000000000000000000000000000
00000000000001111111111000000001100001100000111000000000000000000000000000000000
00000000001100111111111111000111110111111000011110000000000000000000000000000000
00000000001100111111111111111111111111111100111111110000000000000000000000000000
00000000001111111111211111111111011111111111110110000000000000000000000000000000
00000000000001111111111111110000001100110011100010000000000000000000000000000000
00000000000000011111111111110000001100011111100000000000000000000000000000000000
00000000000000011111111111111111001100001011110000000000000000000000000000000000
00000000000000011011111111111111101100001111110000000000000000000000000000000000
00000000000000111001111111111111111100001111010000000000000000000000000000000000
00000000000001111001111110011111111000001111110000000000000000000000000000000000
00000000000011111111111110011111100000000111110000000000000000000000000000000000
00000000000110011111111111111111110110001110000000000000000000000000000000000000
00000000011100111011111111111111111111111100000000000000000000000000000000000000
00000000110000110011111111111111111000111000000000000000000000000000000000000000
00000000000000110011111000001111100000110000000000000000000000000000000000000000
00000000000001100111111000000110000000100000000000000000000000000000000000000000
00000000000000000000000000000000000000000000000000000000000000000000000000000000
