80 80
00000000000000000000000000000000000000000000000000000000000000000000000000000000
00000000000000000000000000100110000000000000000000000000000000000000000000000000
00000000000000000000000101100110000000001000000000000000000000000000000000000000
00000000000000000000000111100010000011001100000000000000000000000000000000000000
00000000000000000000000011100010000110000111100010001000000000000000000000000000
00000000000000000000100111100010000100011110111011111111100000000000000000000000
00000000000000000000111110000110000100010000001111111100000000000000000000000000
00000000000000000010111000001110001111000000011111111000000000000000000000000000
00000000000000000010110000011111111111100001110000111000000000000000000000000000
00000000000000000110110001110011101100000001110000111000000000000000000000000000
00000000000000011111100011100111001100000000110000100000000000000000000000000000
00000000000000011011100011001110000110000000110001100000000000000000000000000000
00000000000000011001100011111110000100000001100001000000000000000000000000000000
00000000000000011001111111111111111000000011100001111110000000000000000000000000
00000000000000110001110111111111111111111111110001111011000000000000000000000000
00000000000000010001110011111111111111111111111111111001000000000000000000000000
00000000000000010000110011111111111112111110011111111001001000000000000000000000
00000000000000000000011111000111111111111100001111111001111000000000000000000000
00000000000000000000011111000011001111111100011100000001110000000000000000000000
00000000000000000000111111000010001110011100111000110001111100000000000000000000
00000000000000000000110011100110001111111111111001111111111110000000000000000000
00000000000000000000000001100010000111111111111011111111111000000000000000000000
00000000000000000000000000000000000111111111111010000011111000000000000000000000
00000000000000000000000000000000000111111111110011110001111110000000000000000000
00000000000000000000000000000011000110001101111011110001100110000000000000000000
00000000000000000000000011111111011100011111111011110001000010000000000000000000
00000000000000000000000000110011111100000011111110110011000000000000000000000000
00000000000000000000000000000001111100000011011110000010000000000000000000000000
00000000000000000000000000000000001100000011011100000110000000000000000000000000
00000000000000000000000000000000000100001011011110010011000000000000000000000000
00000000000000000000000000000000000100001111111011110001000000000000000000000000
00000000000000000000000000000000000100001011110001000001000000000000000000000000
00000000000000000000000000000000000100000000000011000011000000000000000000000000
00000000000000000000000000000000000000000000000111100010000000000000000000000000
00000000000000000000000000000000000000000000000000100010000000000000000000000000
00000000000000000000000000000000000000000000000000100000000000000000000000000000
00000000000000000000000000000000000000000000000000000000000000000000000000000000
00000000000000000000000000000000000000000000000000000000000000000000000000000000
00000000000000000000000000000000000000000000000000000000000000000000000000000000
00000000000000000000000000000000000000000000000000000000000000000000000000000000
00000000000000000000000000000000000000000000000000000000000000000000000000000000
00000000000000000000000000000000000000000000000000000000000000000000000000000000
00000000000000000000000000000000000000000000000000000000000000000000000000000000
00000000000000000000000000000000000000000000000000000000000000000000000000000000
00000000000000000000000000000000000000000000000000000000000000000000000000000000
00000000000000000000000000000000000000000000000000000000000000000000000000000000
00000000000000000000000000000000000000000000000000000000000000000000000000000000
00000000000000000000000000000000000000000000000000000000000000000000000000000000
00000000000000000000000000000000000000000000000000000000000000000000000000000000
00000000000000000000000000000000000000000000000000000000000000000000000000000000
00000000000000000000000000000000000000000000000000000000000000000000000000000000
00000000000000000000000000000000000000000000000000000000000000000000000000000000
00000000000000000000000000000000000000000000000000000000000000000000000000000000
00000000000000000000000000000000000000000000000000000000000000000000000000000000
00000000000000000000000000000000000000000000000000000000000000000000000000000000
00000000000000000000000000000000000000000000000000000000000000000000000000000000
00000000000000000000000000000000000000000000000000000000000000000000000000000000
00000000000000000000000000000000000000000000000000000000000000000000000000000000
00000000000000000000000000000000000000000000000000000000000000000000000000000000
00000000000000000000000000000000000000000000000000000000000000000000000000000000
00000000000000000000000000000000000000000000000000000000000000000000000000000000
00000000000000000000000000000000000000000000000000000000000000000000000000000000
00000000000000000000000000000000000000000000000000000000000000000000000000000000
00000000000000000000000000000000000000000000000000000000000000000000000000000000
00000000000000000000000000000000000000000000000000000000000000000000000000000000
00000000000000000000000000000000000000000000000000000000000000000000000000000000
00000000000000000000000000000000000000000000000000000000000000000000000000000000
00000000000000000000000000000000000000000000000000000000000000000000000000000000
00000000000000000000000000000000000000000000000000000000000000000000000000000000
00000000000000000000000000000000000000000000000000000000000000000000000000000000
00000000000000000000000000000000000000000000000000000000000000000000000000000000
00000000000000000000000000000000000000000000000000000000000000000000000000000000
00000000000000000000000000000000000000000000000000000000000000000000000000000000
00000000000000000000000000000000000000000000000000000000000000000000000000000000
00000000000000000000000000000000000000000000000000000000000000000000000000000000
00000000000000000000000000000000000000000000000000000000000000000000000000000000
00000000000000000000000000000000000000000000000000000000000000000000000000000000
00000000000000000000000000000000000000000000000000000000000000000000000000000000
00000000000000000000000000000000000000000000000000000000000000000000000000000000
00000000000000000000000000000000000000000000000000000000000000000000000000000000
