80 80
00000000000000000000000000000000000000000000000000000000000000000000000000000000
00000000000000000000000000000000000000000000000000000000000000000000000000000000
00000000000000000000000000000000000000000000000000000000000000000000000000000000
00000000000000000000000000000000000000000000000000000000000000000000000000000000
00000000000000000000000000000000000000000000000000000000000000000000000000000000
00000000000000000000000000000000000000000000000000000000000000000000000000000000
00000000000000000000000000000000000000000000000000000000000000000000000000000000
00000000000000000000000000000000000000000000000000000000000000000000000000000000
00000000000000000000000000000000000000000000000000000000000000000000000000000000
00000000000000000000000000000000000000000000000000000000000000000000000000000000
00000000000000000000000000000000000000000000000000000000000000000000000000000000
00000000000000000000000000000000000000000000000000000000000000000000000000000000
00000000000000000000000000000000000000000000000000000000000000000000000000000000
00000000000000000000000000000000000000000000000000000000000000000000000000000000
00000000000000000000000000000000000000000000000000000000000000000000000000000000
00000000000000000000000000000000000000000000000000000000000000000000000000000000
00000000000000000000000000000000000000000000000000000000000000000000000000000000
00000000000000000000000000000000000000000000000000000000000000000000000000000000
00000000000000000000000000000000000000000000000000000000000000000000000000000000
00000000000000000000000000000000000000000000000000000000000000000000000000000000
00000000000000000000000000000000000000000000000000000000000000000000000000000000
00000000000000000000000000000000000000000000000000000000000000000000000000000000
00000000000000000000000000000000000000000000000000000000000000000000000000000000
00000000000000000000000000000000000000000000000000000000000000000000000000000000
00000000000000000000000000000000000000000000000000000000000000000000000000000000
00000000000000000000000000000000000000000000000000000000000000000000000000000000
00000000000000000000000000000000000000000000000000000000000000000000000000000000
00000000000000000000000000000000000000000000000000000000000000000000000000000000
00000000000000000000000000000000000000000000000000000000000000000000000000000000
00000000000000000000000000000000000000000000000000000000000000000000000000000000
00000000000000000000000000000000000000000000000000000000000000000000000000000000
00000000000000000000000000000000000000000000000000000000000000000000000000000000
00000000000000000000000000000000000000000000000000000000000000000000000000000000
00000000000000000000000000000000000000000000000000000000000000000000000000000000
00000000000000000000000000000000000000000000000000000000000000000000000000000000
00000000000000000000000000000000000000000000000000000000000000000000000000000000
00000000000000000000000000000000000000000000000000000000000000000000000000000000
00000000000000000000000000000000000000000000000000000000000000000000000000000000
00000000000000010000000000000000000000000000000000000000000000000000000000000000
00000000000000110000000000000000000000000000000000000000000000000000000000000000
00000000000000111000000000000000000000000000000000000000000000000000000000000000
00000000000000011000000000100000000000000000000000000000000000000000000000000000
00000000000000011000000000110000000000000000000000000000000000000000000000000000
00000000000000011001100001100000000000000000000000000000000000000000000000000000
00000000001111111011100001000000000000000000000000000000000000000000000000000000
00000000011111111011100001000000000000000000000000000000000000000000000000000000
00000000011111111111110001100000000000000000000000000000000000000000000000000000
00000000001111111111110000100000000000000000000000000000000000000000000000000000
00000000001111111110110000100000000000000000000000000000000000000000000000000000
00000000001110111101110001100000000000000000000000000000000000000000000000000000
00000000011100111111110011100000000000000000000000000000000000000000000000000000
00000000011100111111110011000000000000000000000000000000000000000000000000000000
00000000011111111111100011000000010000000000000000000000000000000000000000000000
00000000111110111211100111100000010000000000000000000000000000000000000000000000
00000111111100111111110111100110110110000000000000000000000000000000000000000000
01001111111100111111111111100111111110000000000000000000000000000000000000000000
01111100011100111111111111100011111100000000000000000000000000000000000000000000
00110000001110111111111111111110011000000000000000000000000000000000000000000000
00010000011111111101111110011110001000000000000000000000000000000000000000000000
00111111111111111000111111000010000000000000000000000000000000000000000000000000
01111110111111111001110011100010000000000000000000000000000000000000000000000000
00011100111111111001100000000000000000000000000000000000000000000000000000000000
00001100011111111100000000000000000000000000000000000000000000000000000000000000
00000000000011111100000000000000000000000000000000000000000000000000000000000000
00000000000111111100000000000000000000000000000000000000000000000000000000000000
00000000011111111000000000000000000000000000000000000000000000000000000000000000
00000000110011000000000000000000000000000000000000000000000000000000000000000000
00000000000000000000000000000000000000000000000000000000000000000000000000000000
00000000000000000000000000000000000000000000000000000000000000000000000000000000
00000000000000000000000000000000000000000000000000000000000000000000000000000000
00000000000000000000000000000000000000000000000000000000000000000000000000000000
00000000000000000000000000000000000000000000000000000000000000000000000000000000
00000000000000000000000000000000000000000000000000000000000000000000000000000000
00000000000000000000000000000000000000000000000000000000000000000000000000000000
00000000000000000000000000000000000000000000000000000000000000000000000000000000
00000000000000000000000000000000000000000000000000000000000000000000000000000000
00000000000000000000000000000000000000000000000000000000000000000000000000000000
00000000000000000000000000000000000000000000000000000000000000000000000000000000
00000000000000000000000000000000000000000000000000000000000000000000000000000000
00000000000000000000000000000000000000000000000000000000000000000000000000000000
