80 80
00000000000000000000000000000000000000000000000000000000000000000000000000000000
00000000000000000000000000000000000000000000000000000000000010000011111000111100
00000000000000000000000000000000000000000000000000000000000010000001111100111100
00000000000000000000000000000000000000000000000000000000001011100000110011111100
00000000000000000000000000000000000000000000000000000000001011111000011001111100
00000000000000000000000000000000000000000000000000000000001111001110011111111110
00000000000000000000000000000000000000000000000000000000001110000011001111111110
00000000000000000000000000000000000000000000000000000000000000000001111111111110
00000000000000000000000000000000000000000000000000000000000000111101111111112110
00000000000000000000000000000000000000000000000000000000000011111111111001111110
00000000000000000000000000000000000000000000000000000000000011111111111101111110
00000000000000000000000000000000000000000000000000000000000010111111001111111110
00000000000000000000000000000000000000000000000000000000000001111111000111101100
00000000000000000000000000000000000000000000000000000000000010000111100011111000
00000000000000000000000000000000000000000000000000000000000110000111111111111000
00000000000000000000000000000000000000000000000000000000000010001111111111111000
00000000000000000000000000000000000000000000000000000000000011011110011111111000
00000000000000000000000000000000000000000000000000000000001011011110001111110000
00000000000000000000000000000000000000000000000000000000001110001111111001111010
00000000000000000000000000000000000000000000000000000000000110001111111101111110
00000000000000000000000000000000000000000000000000000000000111001111111101111110
00000000000000000000000000000000000000000000000000000000000011001111111111111100
00000000000000000000000000000000000000000000000000000010000001111001101111111000
00000000000000000000000000000000000000000000000000000111100000110001100111110000
00000000000000000000000000000000000000000000000000001111111111100111101111110000
00000000000000000000000000000000000000000000000000000011111111101111111111111000
00000000000000000000000000000000000000000000000000000010000110011101111010111010
00000000000000000000000000000000000000000000000000000000000000010001100001111110
00000000000000000000000000000000000000000000000000000000000000011011100111000110
00000000000000000000000000000000000000000000000000000000000000111111001111001110
00000000000000000000000000000000000000000000000000000000000011111110011101111100
00000000000000000000000000000000000000000000000000000000000000011110011000000000
00000000000000000000000000000000000000000000000000000000000000000000011000000000
00000000000000000000000000000000000000000000000000000000000000000000011001110000
00000000000000000000000000000000000000000000000000000000000000000000011100010000
00000000000000000000000000000000000000000000000000000000000000000000011100010000
00000000000000000000000000000000000000000000000000000000000000000000011100110000
00000000000000000000000000000000000000000000000000000000000000000000000111100000
00000000000000000000000000000000000000000000000000000000000000000000000110000000
00000000000000000000000000000000000000000000000000000000000000000000000000000000
00000000000000000000000000000000000000000000000000000000000000000000000000000000
00000000000000000000000000000000000000000000000000000000000000000000000000000000
00000000000000000000000000000000000000000000000000000000000000000000000000000000
00000000000000000000000000000000000000000000000000000000000000000000000000000000
00000000000000000000000000000000000000000000000000000000000000000000000000000000
00000000000000000000000000000000000000000000000000000000000000000000000000000000
00000000000000000000000000000000000000000000000000000000000000000000000000000000
00000000000000000000000000000000000000000000000000000000000000000000000000000000
00000000000000000000000000000000000000000000000000000000000000000000000000000000
00000000000000000000000000000000000000000000000000000000000000000000000000000000
00000000000000000000000000000000000000000000000000000000000000000000000000000000
00000000000000000000000000000000000000000000000000000000000000000000000000000000
00000000000000000000000000000000000000000000000000000000000000000000000000000000
00000000000000000000000000000000000000000000000000000000000000000000000000000000
00000000000000000000000000000000000000000000000000000000000000000000000000000000
00000000000000000000000000000000000000000000000000000000000000000000000000000000
00000000000000000000000000000000000000000000000000000000000000000000000000000000
00000000000000000000000000000000000000000000000000000000000000000000000000000000
00000000000000000000000000000000000000000000000000000000000000000000000000000000
00000000000000000000000000000000000000000000000000000000000000000000000000000000
00000000000000000000000000000000000000000000000000000000000000000000000000000000
00000000000000000000000000000000000000000000000000000000000000000000000000000000
00000000000000000000000000000000000000000000000000000000000000000000000000000000
00000000000000000000000000000000000000000000000000000000000000000000000000000000
00000000000000000000000000000000000000000000000000000000000000000000000000000000
00000000000000000000000000000000000000000000000000000000000000000000000000000000
00000000000000000000000000000000000000000000000000000000000000000000000000000000
00000000000000000000000000000000000000000000000000000000000000000000000000000000
00000000000000000000000000000000000000000000000000000000000000000000000000000000
00000000000000000000000000000000000000000000000000000000000000000000000000000000
00000000000000000000000000000000000000000000000000000000000000000000000000000000
00000000000000000000000000000000000000000000000000000000000000000000000000000000
00000000000000000000000000000000000000000000000000000000000000000000000000000000
00000000000000000000000000000000000000000000000000000000000000000000000000000000
00000000000000000000000000000000000000000000000000000000000000000000000000000000
00000000000000000000000000000000000000000000000000000000000000000000000000000000
00000000000000000000000000000000000000000000000000000000000000000000000000000000
00000000000000000000000000000000000000000000000000000000000000000000000000000000
00000000000000000000000000000000000000000000000000000000000000000000000000000000
00000000000000000000000000000000000000000000000000000000000000000000000000000000
