80 80
00000000000000000000000000000000000000000000000000000000000000000000000000000000
01111110011101111111111111111110000000000000000000000000000000000000000000000000
00100000011110011100011100000111000000000000000000000000000000000000000000000000
01110000111111011100011100000111110000000000000000000000000000000000000000000000
01111101111111111000111111000110010001000000000000000000000000000000000000000000
01111111111111111001111111100011011111000000000000000000000000000100000000000000
01100111111111111111111111110011000000000000000000000000000000001100000000000000
00000000011111111111111100011011100000000000000000000000000000011000000000000000
00000000011111111111111110001110100001000000000000000000000011111000000000000000
00001000111110111111111111000110110111110000000000111010000011111000001000000000
01111111111111111111111111100011111110011100000001110111100010011110001000000000
01111111111111110111111111100011111100000000001111100001100110000110001110000000
00111111100001000110111111110111111000000000001111100001000110010110000110000000
00111111100000001100111111111111111000000000000111000001000100110110000010000000
00111111111010011000111011111111011100010000011111100001000111110110000111000100
00011110111111111001110111100111001110111100111111100011100111111110111111111100
00011100001111110001110111000111000111101111110100110001100011101100110010000000
01111000001111100011101100000111000011100000110100010001100111100000000010000000
00000000011100110011111000000111000011111000111100011001111111110000001111100000
00000001101100011110110110000111000110011100111100111001111111111100011100110100
00000001111000011111100111100111011110011101111111110011100111101110011100111110
00000000111000010110111111111111111110011101111111100011100111100111011100011110
00000000110000010110111111111110011111110001111111000111000011100011111100111100
00000000000000010010010111111100011111000001111111000111100001100011111101110000
00000000000000010011010001111110011111001111111011111111111111100111011100110000
00000000000000010001110011111111111111111110111001111111111111001110011100111000
00000000000000010000000111011011111111111111111001111111111110011110011100010000
00000000000000000000000111011001111111111111111111111111111100011110000011000000
00000000000000000000001111111001111111001111111111111111111000111111100001110000
00000000000000000000000011011011101110001111111111112111111111111111111000110000
00000000000000000000000001111111101100011111111111111111111111111111111100010000
00000000000000000000000001111100001100011111111111111111111111000111100110110000
00000000000000000000000000111000001100011111110111111111111100000011000011110000
00000000000000000000000000001000000011111111100111100111111000000011000011111110
00000000000000000000000000000000000110011111111111111111111111100111001111111110
00000000000000000000000000000000000100011111111111111111111111111111111111111110
00000000000000000000000000000000000100001110111111111111111111111110111001111110
00000000000000000000000000000000000000000011000111111111111111111100110000000110
00000000000000000000000000000000000000000000000011100111111111111100100000000110
00000000000000000000000000000000000000000000000001110111111111001110111111001100
00000000000000000000000000000000000000000000000001110011111111001111111111111110
00000000000000000000000000000000000000000000000000110011111111101110111000000010
00000000000000000000000000000000000000000000000000011000111111111110010000000010
00000000000000000000000000000000000000000000000000011000111111111111111000001110
00000000000000000000000000000000000000000000000000111111111111111111111000011110
00000000000000000000000000000000000000000000000001111111111111111111111000111110
00000000000000000000000000000000000000000000000001100111111111111111101100011100
00000000000000000000000000000000000000000000000000000111000000110111000110001000
00000000000000000000000000000000000000000000000000000100000000110000000111111000
00000000000000000000000000000000000000000000000000011110000110111111001111111100
00000000000000000000000000000000000000000000000001111111111111111111111111111000
00000000000000000000000000000000000000000000000011000000111011111101111001111100
00000000000000000000000000000000000000000000000110000000011011110000011000011100
00000000000000000000000000000000000000000000000000000000111111110000011100000110
00000000000000000000000000000000000000000000000000000000001111111100011000011110
00000000000000000000000000000000000000000000000000000000001111111100011100111110
00000000000000000000000000000000000000000000000000000000000011100110001100000010
00000000000000000000000000000000000000000000000000000000000000000110001000000000
00000000000000000000000000000000000000000000000000000000000000000100111000000000
00000000000000000000000000000000000000000000000000000000000000000100101100000000
00000000000000000000000000000000000000000000000000000000000000001111111000000000
00000000000000000000000000000000000000000000000000000000000000000001111000000000
00000000000000000000000000000000000000000000000000000000000000000000011000000000
00000000000000000000000000000000000000000000000000000000000000000000000000000000
00000000000000000000000000000000000000000000000000000000000000000000000000000000
00000000000000000000000000000000000000000000000000000000000000000000000000000000
00000000000000000000000000000000000000000000000000000000000000000000000000000000
00000000000000000000000000000000000000000000000000000000000000000000000000000000
00000000000000000000000000000000000000000000000000000000000000000000000000000000
00000000000000000000000000000000000000000000000000000000000000000000000000000000
00000000000000000000000000000000000000000000000000000000000000000000000000000000
00000000000000000000000000000000000000000000000000000000000000000000000000000000
00000000000000000000000000000000000000000000000000000000000000000000000000000000
00000000000000000000000000000000000000000000000000000000000000000000000000000000
00000000000000000000000000000000000000000000000000000000000000000000000000000000
00000000000000000000000000000000000000000000000000000000000000000000000000000000
00000000000000000000000000000000000000000000000000000000000000000000000000000000
00000000000000000000000000000000000000000000000000000000000000000000000000000000
00000000000000000000000000000000000000000000000000000000000000000000000000000000
00000000000000000000000000000000000000000000000000000000000000000000000000000000
