80 80
00000000000000000000000000000000000000000000000000000000000000000000000000000000
00000000000000000000000000000000000000000000000000000000000000000000000000000000
00000000000000000000000000000000000000000000000000000000000000000000000000000000
00000000000000000000000000000000000000000000000000000000000000000000000000000000
00000000000000000000000000000000000000000000000000000000000000000000000000000000
00000000000000000000100000000000000000000000000000000000000000000000000000000000
00000000000000000000100000000000000000000000000000000000000000000000000000000000
00000000000000000000100000000000000000000000000000000000000000000000000000000000
00000000000000000000100000000000000000000000000000000000000000000000000000000000
00000000001100000000100000000000000000000000000000000000000000000000000000000000
00000000001000000000100000000000000000000000000000000000000000000000000000000000
00000000011000000001100000000000000000000000000000000000000000000000000000000000
00000000011110000011000000000000000000000000000000000000000000000000000000000000
00000111111110011110000000000000000000000000000000000000000000000000000000000000
00000110111110011000000000000000000000000000000000000000000000000000000000000000
00001110011110111000000000000000000000000000000000000000000000000000000000000000
00001110011111110000000000000000000000000000000000000000000000000000000000000000
01111111111111110000000000000000000000000000000000000000000000000000000000000000
01111111111111110000001000000000000000000000000000000000000000000000000000000000
01111110011111111000111000000000000000000000000000000000000000000000000000000000
01111110011111111000111000000000000000000000000000000000000000000000000000000000
01111111111000111001101000000000000000000000000000000000000000000000000000000000
00111111110001111111101000000000000000000000000000000000000000000000000000000000
00011111100011111011100000000000000000000000000000000000000000000000000000000000
01111110111111111001110000000000000000000000000000000000000000000000000000000000
01111111111111111001111111100000000000000000000000000000000000000000000000000000
01111111111110111001111100000000000000000000000000000000000000000000000000000000
00111111100000111111111000000000000000000000000000000000000000000000000000000000
00101111100111111111100000000000000000000000000000000000000000000000000000000000
00001111111111111111100000000000000000000000000000000000000000000000000000000000
00001111111111111121110000000000000000000000000000000000000000000000000000000000
00000111111111111111111000000000000000000000000000000000000000000000000000000000
00000111001111111111111000000000000000000000000000000000000000000000000000000000
01000111001111111111110000000000000000000000000000000000000000000000000000000000
01111111111111111000110000000000000000000000000000000000000000000000000000000000
01011111111111111101100000000000000000000000000000000000000000000000000000000000
01011111001111111111100000000000000000000000000000000000000000000000000000000000
01111001001111111111110000000000000000000000000000000000000000000000000000000000
00110001111111111111110000000000000000000000000000000000000000000000000000000000
01110111111111111111111000000000000000000000000000000000000000000000000000000000
01111111111111111111111111100000000000000000000000000000000000000000000000000000
01111100111111011000111000000000000000000000000000000000000000000000000000000000
00110000011110000000011000000000000000000000000000000000000000000000000000000000
00011000001100001100011000000011000000000000000000000000000000000000000000000000
00111100001100011111111000000010000000000000000000000000000000000000000000000000
01111100001000111111111111100010000000000000000000000000000000000000000000000000
01111100011000111111100111110110000000000000000000000000000000000000000000000000
00111000010000111000000011111100000000000000000000000000000000000000000000000000
00010000100000110000000011111100000110000000000000000000000000000000000000000000
00010011111000111011100001111110000110000000000000000000000000000000000000000000
01011111111100111111110011111111001110000000000000000000000000000000000000000000
01011001111110111100111011111111111100000000000000000000000000000000000000000000
01111000110010001000000011110000010000000000000000000000000000000000000000000000
00111100011011001100000111100000000000000000000000000000000000000000000000000000
00011110001111111111100111100000000000000000000000000000000000000000000000000000
01111110001111111001111111110000000000000000000000000000000000000000000000000000
00111100001101110000111100000000000000000000000000000000000000000000000000000000
00011100001111100000011000000000000000000000000000000000000000000000000000000000
00111110001111110000111000000000000000000000000000000000000000000000000000000000
01101111011111111001110000000000000000000000000000000000000000000000000000000000
01001111111111111001110011111111100000000000000000000000000000000000000000000000
00011111111111111001111110000000110000000000000000000000000000000000000000000000
00001111100111111000011100000000000000000000000000000000000000000000000000000000
00000111100111110000001100000000000000000000000000000000000000000000000000000000
00000111111111111001111100000000000000000000000000000000000000000000000000000000
01000110111111111001110000000000000000000000000000000000000000000000000000000000
01001100011100011110110000000000000000000000000000000000000000000000000000000000
01111000001000000000000000000000000000000000000000000000000000000000000000000000
01100000011100011000011110000000000000000000000000000000000000000000000000000000
01000111111111111111100110000000000000000000000000000000000000000000000000000000
01001111111101111111111111000000000000000000000000000000000000000000000000000000
00001111111111111110111000000000000000000000000000000000000000000000000000000000
00011111111111110010000000000000000000000000000000000000000000000000000000000000
00011100110011110010000000000000000000000000000000000000000000000000000000000000
00001100111111110000000000000000000000000000000000000000000000000000000000000000
00000110011100110000000000000000000000000000000000000000000000000000000000000000
00000010000000011000000000000000000000000000000000000000000000000000000000000000
00000010000000111000000000000000000000000000000000000000000000000000000000000000
00000000000001111100000000000000000000000000000000000000000000000000000000000000
00000000000000000000000000000000000000000000000000000000000000000000000000000000
