80 80
00000000000000000000000000000000000000000000000000000000000000000000000000000000
00000000000000000000000000000000000000000000000000000000000000000000000000000000
00000000000000000000000000000000000000000000000000000000000000000000000000000000
00000000000000000000000000000000000000000000000000000000000000000000000000000000
00000000000000000000000000000000000000000000000000000000000000000000000000000000
00000000000000000000000000000000000000000000000000000000000000000000000000000000
00000000000000000000000000000000000000000000000000000000000000000000000000000000
00000000000000000000000000000000000000000000000000000000000000000000000000000000
00000000000000000000000000000000000000000000000000000000000000000000000000000000
00000000000000000000000000000000000000000000000000000000000000000000000000000000
00000000000000000000000000000000000000000000000000000000000000000000000000000000
00000000000000000000000000000000000000000000000000000000000000000000000000000000
00000000000000000000000000000000000000000000000000000000000000000000000000000000
00000000000000000000000000000000000000000000000000000000000000000000000000000000
00000000000000000000000000000000000000000000000000000000000000000000000000000000
00000000000000000000000000000000000000000000000000000000000000000000000000000000
00000000000000000000000000000000000000000000000000000000000000000000000000000000
00000000000000000000000000000000000000000000000000000000000000000000000000000000
00000000000000000000000000000000000000000000000000000000000000000000000000000000
00000000000000000000000000000000000000000000000000000000000000000000000000000000
00000000000000000000000000000000000000000000000000000000000000000000000000000000
00000000000000000000000000000000000000000000000000000000000000000000000000000000
00000000000000000000000000000000000000000000000000000000000000000000000000000000
00000000000000000000000000000000000000000000000000000000000000000000000000000000
00000000000000000000000000000000000000000000000000000000000000000000000000000000
00000000000000000000000000000000000000000000000000000000000000000000000000000000
00000000000000000000000000000000000000000000000000000000000000000000000000000000
00000000000000000000000000000000000000000000000000000000000000000000000000000000
00000000000000000000000000000000000000000000000000000000000000000000000000000000
00000000000000000000000000000000000000000000000000000000000000000000000000000000
00000000000000000000000000000000000000000000000000000000000000000000000000000000
00000000000000000000000000000000000000000000000000000000000000000000000000000000
00000000000000000000000000000000000000000000000000000000000000000000000000000000
00000000000000000000000000000000000000000000000000000000000000000000000000000000
00000000000000000000000000000000000000000000000000000000000000000000000000000000
00000000000000000000000000000000000000000000000000000000000000000000000000000000
00000000000000000000000000000000000000000000000000000000000000000000000000000000
00000000000000000000000000000000000000000000000000000000000000000000000000000000
00000000000000000000000000000000000000000000000000000000000000000000000000000000
00000000000000000000000000000000000000000000000000000000000000000000000000000000
00000000000000000000000000000000000000000000000000000000000000000000000000000000
00000000000000000000000000000000000000000000000000000000000000000000000000000000
00000000000000000000000000000000000000000000000000000000000000000000000000000000
00000000000000000000000000000000000000000000000000000000000000000000000000000000
00000000000000000000000000000000000000000000000000000000000000000000000000001000
00000000000000000000000000000000000000000000000000000000000000000000000000111000
00000000000000000000000000000000000000000000000000000000000000000000000001110000
00000000000000000000000000000000000000000000000000000000000000000000000011000000
00000000000000000000000000000000000000000000000000000000000000010000000110000000
00000000000000000000000000000000000000000000000000000000000000011000001111000000
00000000000000000000000000000000000000000000000000000000000000011111101001111110
00000000000000000000000000000000000000000000000000000000000000000111111001000010
00000000000000000000000000000000000000000000000000000000000000100001110000000000
00000000000000000000000000000000000000000000000000000000000011100001110000110000
00000000000000000000000000000000000000000000000000000000000011100111111000010000
00000000000000000000000000000000000000000000000000000000000111100101111000011000
00000000000000000000000000000000000000000000000000000000000011100101111100111010
00000000000000000000000000000000000000000000000000000000000010111100111101111110
00000000000000000000000000000000000000000000000000000000000000000100011111121110
00000000000000000000000000000000000000000000000000000000000011001110001100111010
00000000000000000000000000000000000000000000000000000001111111111110011100010000
00000000000000000000000000000000000000000000000000000000011110011110011000011000
00000000000000000000000000000000000000000000000000000000011110011111100000011100
00000000000000000000000000000000000000000000000000000000100011001111000000011110
00000000000000000000000000000000000000000000000000000001100011001110111000111110
00000000000000000000000000000000000000000000000000000001000011000111111100111110
00000000000000000000000000000000000000000000000000000011000000000111011111111110
00000000000000000000000000000000000000000000000000000011000000000111111111111000
00000000000000000000000000000000000000000000000000000001000000001110011111011000
00000000000000000000000000000000000000000000000000011001100001111100001110111110
00000000000000000000000000000000000000000000000001111111101111111100011100111110
00000000000000000000000000000000000000000000000011001111001100110110111000011110
00000000000000000000000000000000000000000000000000000111111000011111111111111110
00000000000000000000000000000000000000000000000000000010010000000011111111111110
00000000000000000000000000000000000000000000000000000011001001100111111100110000
00000000000000000000000000000000000000000000000000000001111111111110011100010000
00000000000000000000000000000000000000000000000000000001111111111000001100011000
00000000000000000000000000000000000000000000000000000001000111110000000000011000
00000000000000000000000000000000000000000000000000000000001100111000000000001100
00000000000000000000000000000000000000000000000000000000000000000000000000000000
