80 80
00000000000000000000000000000000000000000000000000000000000000000000000000000000
00000000000000000000000000000000000000000000000000000000000000000000000000000000
00000000000000000000000000000000000000000000000000000000000000000000000000000000
00000000000000000000000000000000000000000000000000000000000000000000000000000000
00000000000000000000000000000000000000000000000000000000000000000000000000000000
00000000000000000000000000000000000000000000000000000000000000000000000000000000
00000000000000000000000000000000000000000000000000000000000000000000000000000000
00000000000000000000000000000000000000000000000000000000000000000000000000000000
00000000000000000000000000000000000000000000000000000000000000000000000000000000
00000000000000000000000000000000000000000000000000000000000000000000000000000000
00000000000000000000000000000000000000000000000000000000000000000000000000000000
00000000000000000000000000000000000000000000000000000000000000000000000000000000
00000000000000000000000000000000000000000000000000000000000000000000000000000000
00000000000000000000000000000000000000000000000000000000000000000000000000000000
00000000000000000000000000000000000000000000000000000000000000000000000000000000
00000000000000000000000000000000000000000000000000000000000000000000000000000000
00000000000000000000000000000000000000000000000000000000000000000000000000000000
00000000000000000000000000000000000000000000000000000000000000000000000000000000
00000000000000000000000000000000000000000000000000000000000000000000000000000000
00000000000000000000000000000000000000000000000000000000000000000000000000000000
00000000000000000000000000000000000000000000000000000000000000000000000000000000
00000000000000000000000000000000000000000000000000000000000000000000000000000000
00000000000000000000000000000000000000000000000000000000000000000000000000000000
00000000000000000000000000000000000000000000000000000000000000000000000000000000
00000000000000000000000000000000000000000000000000000000000000000000000000000000
00000000000000000000000000000000000000000000000000000000000000000000000000000000
00000000000000000000000000000000000000000000000000000000000000000000000000000000
00000000000000000000000000000000000000000000000000000000000000000000000000000000
00000000000000000000000000000000000000000000000000000000000000000000000000000000
00000000000000000000000000000000000000000000000000000000000000000000000000000000
00000000000000000000000000000000000000000000000000000000000000000000000000000000
00000000000000000000000000000000000000000000000000000000000000000000000000000000
00000000000000000000000000000000000000000000000000000000000000000000000000000000
00000000000000000000000000000000000000000000000000000000000000000000000000000000
00000000000000000000000000000000000000000000000000000000000000000000000000000000
00000000000000000000000000000000000000000000000000000000000000000000000000000000
00000000000000000000000000000000000000000000000000000000000000000000000000000000
00000000000000000000000000000000000000000000000000000000000000000000000000000000
00000000000000000000000000000000000000000000000000000000000000000000000000000000
00000000000000000000000000000000000000000000000000000000000000000000000000000000
00000000000000000000000000000000000000000000000000000000000000000000000000000000
00000000000000000000000000000000000000000000000000000000000000000000000000000000
00000000000000000000000000000000000000000000000000000000000000000000000000000000
00000000000000000000000000000000000000000000000000000000000000000000000000000000
00000000000000000000000000000000000000000000000000000000000000000000000000000000
00000000000000000000000000000000000000000000000000000000000000000000000000000000
00000000000000000000000000000000000000000000000000000000000000000000000000000000
00000000000000000000000000000000000000000000000000000000000000000000000000000000
00000000000000000000000000000000000000000000000000000000000000000000000000000100
00000000000000000000000000000000000000000000000000000000000000000001011100001110
00000000000000000000000000000000000000000000000000000000000000001111111101111110
00000000000000000000000000000000000000000000000000000000000000000000011111100010
00000000000000000000000000000000000000000000000000000000000000100000011100000010
00000000000000000000000000000000000000000000000000000000000001110000000000000110
00000000000000000000000000000000000000000000000001110000000011111000111000001110
00000000000000000000000000000000000000000000000011110000000010001111111111111000
00000000000000000000000000000000000000000000000011110000000110000110000111110000
00000000000000000000000000000000000000000000000001110000011100000000000011100000
00000000000000000000000000000000000000000001000110011000001011100001000011110000
00000000000000000000000000000000000000000001000011111110001111101111111111111000
00000000000000000000000000000000000000000001111111110011111111111111111111111000
00000000000000000000000000000000000000000001000011110001111111111110001111110000
00000000000000000000000000000000000000000001000001111111110000111110000111110010
00000000000000000000000000000000000000000000000001001111100000111001100011111110
00000000000000000000000000000000000000000000000001100001110001111100111111111110
00000000000000000000000000000000000000000000000001111011101111111111111111121110
00000000000000000000000000000000000000000000000000011111001111000111111111111100
00000000000000000000000000000000000000000000000000011000000011101111000011111100
00000000000000000000000000000000000000000000000000010000000111111111000110011110
00000000000000000000000000000000000000000000000000000000000111111110001111111110
00000000000000000000000000000000000000000000000000000000000111111110011111111010
00000000000000000000000000000000000000000000000000000000000011111110111011110010
00000000000000000000000000000000000000000000000000000000000001111110110001110010
00000000000000000000000000000000000000000000000000000000000000000100111011100010
00000000000000000000000000000000000000000000000000000000000000001100011111110010
00000000000000000000000000000000000000000000000000000000000000001110011110110010
00000000000000000000000000000000000000000000000000000000000000000111111100011000
00000000000000000000000000000000000000000000000000000000000000000011111100011000
00000000000000000000000000000000000000000000000000000000000000001110011100011000
00000000000000000000000000000000000000000000000000000000000000000000000000000000
