80 80
00000000000000000000000000000000000000000000000000000000000000000000000000000000
00000000000000000000000000000000000000000000000000000000000000000000000000000000
00000000000000000000000000000000000000000000000000000000000000000000000000000000
00000000000000000000000000000000000000000000000000000000000000000000000000000000
00000000000000000000000000000000000000000000000000000000000000000000000000000000
00000000000000000000000000000000000000000000000000000000000000000000000000000000
00000000000000000000000000000000000000000000000000000000000000000000000000000000
00000000000000000000000000000000000000000000000000000000000000000000000000000000
00000000000000000000000000000000000000000000000000000000000000000000000000000000
00000000000000000000000000000000000000000000000000000000000000000000000000000000
00000000000000000000000000000000000000000000000000000000000000000000000000000000
00000000000000000000000000000000000000000000000000000000000000000000000000000000
00000000000000000000000000000000000000000000000000000000000000000000000000000000
00000000000000000000000000000000000000000000000000000000000000000000000000000000
00000000000000000000000000000000000000000000000000000000000000000000000000000000
00000000000000000000000000000000000000000000000000000000000000000000000000000000
00000000000000000000000000000000000000000000000000000000000000000000000000000000
00000000000000000000000000000000000000000000000000000000000000000000000000000000
00000000000000000000000000000000000000000000000000000000000000000000000000000000
00000000000000000000000000000000000000000000000000000000000000000000000000000000
00000000000000000000000000000000000000000000000000000000000000000000000000000000
00000000000000000000000000000000000000000000000000000000000000000000000000000000
00000000000000000000000000000000000000000000000000000000000000000000000000000000
00000000000000000000000000000000000000000000000000000000000000000000000000000000
00000000000000000000000000000000000000000000000000000000000000000000000000000000
00000000000000000000000000000000000000000000000000000000000000000000000000000000
00000000000000000000000000000000000000000000000000000000000000000000000000000000
00000000000000000000000000000000000000000000000000000000000000000000000000000000
00000000000000000000000000000000000000000000000000000000000000000000000000000000
00000000000000000000000000000000000000000000000000000000000000000000000000000000
00000000000000000000000000000000000000000000000000000000000000000000000000000000
00000000000000000000000000000000000000000000000000000000000000000000000000000000
00000000000000000000000000000000000000000000000000000000000000000000000000000000
00000000000000000000000000000000000000000000000000000000000000000000000000000000
00000000000000000000000000000000000000000000000000000000000000000000000000000000
00000000000000000000000000000000000000000000000000000000000000000000000000000000
00000000000000000000000000000000000000000000000000000000000000000000000000000000
00000000000000000000000000000000000000000000000000000000000000000000000000000000
00000000000000000000000000000000000000000000000000000000000000000000000000000000
00000000000000000000000000000000000000000000000000000000000000000000000000000000
00000000000000000000000000000000000000000000000000000000000000000000000000000000
00000000000000000000000000000000000000000000000000000000000000000000000000000000
00000000000000000010000000000000000000000000000000000000000000000000000000000000
00000000000000000010000110000000001000000000011100000000000000000000000000000000
00000000000000000011000101111110001100000000010110100000000000000000000000000000
00000000000000000011110111100010000100011111111111100000000000000000000000000000
00000000000000000110111011000010000110100011001110100000000000000000000000000000
00000000000000000010011111000011000111100001000100000011000000000000000000000000
00000000000000000000011111111011001111100000001100001101110000000000000000000000
00000000000000000000110011111111111111111000111100011000111100000000000000000000
00000000000000000001110011111111111111111100111111111111110000000000000000000000
00000000000000000001100001110111111111111101111111000110010000000000000000000000
00000000000000000001000000100011100111111111000110000011110000000000000000000000
00000000000000000001000001000001000111111111000010000001100000000000000000000000
00000000000000000001100111100011000110011001100011000001000011000000000000000000
00000000000000000000110111100111101100001101111111110011110010000000000000000000
00000000000000000100111111100110011100001110001100111111111110000000000000000000
00000000000000000111111111001110011100000010000100001111111110000000000000000000
00000000000000000011111001100011111100000010000100001111110011011000000000000000
00000000000000000000110001100011111100000110001110111111110011111100000000000000
00000000000000000000100001000011111111111111111111111112111111110100000000000000
00000000000000000000000000000110110111111111110011110111111110100100000000000000
00000000000000000000000000000000000011110001000010000111111000100000000000000000
00000000000000000000000000000000000001000001000010000011111000100000000000000000
00000000000000000000000000000000000000000000100111000011111100100000000000000000
00000000000000000000000000000000000000000000111111111111111111100000000000000000
00000000000000000000000000000000000000000000111100011111110000000000000000000000
00000000000000000000000000000000000000000001111000000111110000000000000000000000
00000000000000000000000000000000000000000000000000000001111100000000000000000000
00000000000000000000000000000000000000000000000000000001110110000000000000000000
00000000000000000000000000000000000000000000000000000111110010000000000000000000
00000000000000000000000000000000000000000000000000000000000010000000000000000000
00000000000000000000000000000000000000000000000000000000000000000000000000000000
00000000000000000000000000000000000000000000000000000000000000000000000000000000
00000000000000000000000000000000000000000000000000000000000000000000000000000000
00000000000000000000000000000000000000000000000000000000000000000000000000000000
00000000000000000000000000000000000000000000000000000000000000000000000000000000
00000000000000000000000000000000000000000000000000000000000000000000000000000000
00000000000000000000000000000000000000000000000000000000000000000000000000000000
00000000000000000000000000000000000000000000000000000000000000000000000000000000
