80 80
00000000000000000000000000000000000000000000000000000000000000000000000000000000
00000000011111111111111111111111001111111111111111101111001111111100011001111100
00000000000111001111101100111011101111101111111110000111001100110000010000111100
00000000001111000111001100110011111110001111111100001110001111110000010000011110
00000000001111111111111101110111111111011111111110110111001111111000011000111110
00000000001111111111111111100111111111111111111111110011111111111110011100111100
00000000001111111111111111001111111111111011111111110001011111100011001111111000
00000000011111011100000100001110111111110001111111110000000011000001000111110000
00000011111111111110000100001110111111110001111011110111111111100001000111111110
00000011001111111111100111001111110110011011111001100001111211110001001110111110
00000111111100111111110011100111111100011111111000100011111111111111111100111110
00000000111000011100110001110111111100001111110000110011001111110001111000111110
00000000111101111100000000010001111100000011110000111111001100110000100001100110
00000000101110001110100000010001111100000011111111111011001000010000100000110010
00000000001110011111100001110011111100000111111111111001000100011100111101111010
00000000011111111001110011100111111100011111111111111001000111101111111111111110
00000000011011110000111111000110111110011001111111111101000011100111111111111110
00000000111111100000011111000110011111110001000011111100000001100001000011011110
00000000011100000000111011111110001100000000000001101100001111000001000011001110
00000000011100000000110001111110000100011000000001101110000111010111111111111110
00000000011100000000100001111110000100001000000001110011100111111111111111111110
00000000001100000000100111001110000110001000000000010000111011111111111111110000
00000000011110000001001110000000000011111100000000000000110000000001100011000000
00000000011111000011111000000000000000011000000000000000110000000001100010000000
00001000001101110011110000000000000000001000000000000001110100111111101110111000
00001111011100111111100000000000000000001000000000000011100111111111111111111110
00000111111000001111100000000000000000001000000000000011111111111111111101111110
00000001111000000000000000000000000000000000000000000011111111000111111111000110
00000001111000000000000000000000000000000000000000000011000111100110011111000110
00000111111100001100000000000000000000000000000000000011000111111110011111111110
01111110011100111000000000000000000000000000000000000001000111111110011111111110
00011100011111110000000000000000000000000000000000000001100011111100001111111110
00001100010000110000000000000000000000000000000000000000000000011100000000111110
00011101100000111000000000000000000000000000000000000000000000111111110000111110
00111111111000011111100000000000000000000000000000000000000001001111111000111110
01111111111110111111110000000000000000000000000000000000000111001110011111111110
00111111111111110011110000000000000000000000000000000000000110001110001111111100
00011100001111100011110000000000000000000000000000000000001100001110000101110110
00111000011111100011110000000000000000000000000000000011000100000110000000111010
01111100111100110011110000000000000000000000000000000001000110000110001000111000
01111111111100011011110011000000000000000000000000000001000011001110011000011000
01100111111100011111111110000000000000000000000000000001000011111000001100011000
01110001111100011100001110000000000000000000000000000011100000100000001100011110
00111101111011110000000100000000000000000000000100000111111100000000001100001000
01001110111111111000110000000000000000000000001100011111000110000111111100001000
01001111111110111000110000000000000000000000011111111111100111001111111100111100
01001111111100110001100000000000000000000000000011000001100011001100000001100110
01011111111111110001111000000000000000000000000010000001100011111110000001000010
01111111111111111111111000000000000000000000000111000000000111111000000001000000
01101110111111111111100000000000000000000000001101100000000111001100110001100000
01001110011111111101110000000000000000000000111000100000000111001110011111111000
00001110011111111100111000000000000000000001100000111100000011000110000110011000
01001111111100001100000000000000000000000111110000001000000001000000000110111110
01111110111000011100000000000000000000000000000000001000000001110000001111110110
01001110001100111110100000000000000000000000000000000000000011100111001100110110
01001110011100111111111100000000000000000000000000000000000011111111111000111110
00101100011000111100000000000000000000000000000000000000000000011001111000011100
00101100010000111000000000000000000000000000000000000000000000001000111000000000
01111100010001011000000000000000000000000000000000000000000000011001111000111000
01111100011011010000000000000000000000000000000000000000000010001111111001111010
01011100011111010000000000000000000000000000000000000000000011001111111101111110
00010100001111110000000000000000000000000000000000000000000010001111001111111100
00000100001111100000000000000000000000000000000000000000000011111111101111111100
00000000011111100000000000000000000000000000000000000000000011111110111011111110
00000000011111110000000000000000000000000000000000000000000011100100011000110010
00000000001100010000000000000000000000000000000000000000000011000100011110011010
00000000001000000000000000000000000000000000000000000000000000000000011110011110
00000000000000000000000000000000000000000000000000000000000000000000011101100000
00000000000000000000000000000000000000000000000000000000000000000000000111000000
00000000000000000000000000000000000000000000000000000000000000001100001111100000
00000000000000000000000000000000000000000000000000000000000000000110011100111110
00000000000000000000000000000000000000000000000000000000000000000111110000001110
00000000000000000000000000000000000000000000000000000000000000000011000000000110
00000000000000000000000000000000000000000000000000000000000000000010000000000110
00000000000000000000000000000000000000000000000000000000000000000110011000011110
00000000000000000000000000000000000000000000000000000000000000000100011100111110
00000000000000000000000000000000000000000000000000000000000000000100001111111110
00000000000000000000000000000000000000000000000000000000000000000000000011111000
00000000000000000000000000000000000000000000000000000000000000000000000000011000
00000000000000000000000000000000000000000000000000000000000000000000000000000000
