80 80
00000000000000000000000000000000000000000000000000000000000000000000000000000000
00000000000000110000000000000000000000000000000000000000000000000000000000000000
00000000000000110000000000000000000000000000000000000000000000000000000000000000
00000000000001111000000000100000000000000000000000000000000000000000000000000000
01000110000010011000000001111100000000000000000000000000000000000000000000000000
01111110111111111011111001111110000000000000000000000000000000000000000000000000
00111100111111110001001111011011000000000000000000000000000000000000000000000000
00011100111111110000000111011011000000000000000000000000000000000000000000000000
00011111111110000000000001111011000000000000000000000000000000000000000000000000
01111111011110011111100001111110111100000000000000000000000000000000000000000000
01111110111111111111110011111111111100000000000000000000000000000000000000000000
01111110100111110111111111011011111110000000000000000000000000000000000000000000
00111001000000110111111110010001111111100000000000000000000000000000000000000000
00011001000000111000111000010001111110110000000000000000000000000000000000000000
01111111111111111000111101110011101100000000000000000000000000000000000000000000
01111111111111111001111111100111001100000000000000000000000000000000000000000000
01111111111111110001100111111100000110000000000000000000000000000000000000000000
01111011111111000011000011110000000110000000000000000000000000000000000000000000
01111111001111000011000011100000000110000000000000000000000000000000000000000000
01111111001111110001100011000000000110000000000000000000000000000000000000000000
01111110011111111101110011100111111110000000000000000000000000000000000000000000
01111111111100111101110001111110111100000000000000000000000000000000000000000000
01111111111001111100110001111100000000000000000000000000000000000000000000000000
01111211111111111000110001111110000000000000000000000000000000000000000000000000
01111111111111111001110011101111000011000000000000000000000000000000000000000000
01111111111111111101110011100111111110000000000000000000000000000000000000000000
00001111111111111111110011100111110000000000000000000000000000000000000000000000
00000000100011111111110011111111100000000000000000000000000000000000000000000000
01000000110001111111100111101110000000000000000000000000000000000000000000000000
01110011111111111111111111000110000000000000000000000000000000000000000000000000
01111111111111111101111111000010000000000000000000000000000000000000000000000000
01011100001111111100111001100010000000000000000000000000000000000000000000000000
00000000000110001100000001100000000000000000000000000000000000000000000000000000
01100111000110000100000011111110000000000000000000000000000000000000000000000000
01111111101111111101110111111010000000000000000000000000000000000000000000000000
01111111111111111111111111111110000000000000000000000000000000000000000000000000
00100111111001110011111111011110000000000000000000000000000000000000000000000000
00100011000000110011111001001100000000000000000000000000000000000000000000000000
00000001000011111111111000111100000000000000000000000000000000000000000000000000
00000011001111111111110001111110000000000000000000000000000000000000000000000000
00011111111111111111111111111110000000000000000000000000000000000000000000000000
00011000011101111111111111111011000000000000000000000000000000000000000000000000
01110000011111111110000010011001100000000000000000000000000000000000000000000000
01111100011110111111000000011100100000000000000000000000000000000000000000000000
00011111111110111111100011111110100000000000000000000000000000000000000000000000
00011111111111111001110011110111111110000000000000000000000000000000000000000000
00001101100000111000111011110010000000000000000000000000000000000000000000000000
00000001100000111000011011111000000000000000000000000000000000000000000000000000
00000000100000011110001001100000000000000000000000000000000000000000000000000000
00000000110000111111111001100000000000000000000000000000000000000000000000000000
00000000011100111111111011000000000000000000000000000000000000000000000000000000
00000000001111111111111110000000000000000000000000000000000000000000000000000000
00000000000000000110111000000000000000000000000000000000000000000000000000000000
00000000000000000100011000000000000000000000000000000000000000000000000000000000
00000000000000011100000000000000000000000000000000000000000000000000000000000000
00000000000000011100000000000000000000000000000000000000000000000000000000000000
00000000000000110000000000000000000000000000000000000000000000000000000000000000
00000000000001100000000000000000000000000000000000000000000000000000000000000000
00000000000111000000000000000000000000000000000000000000000000000000000000000000
00000000001100000000000000000000000000000000000000000000000000000000000000000000
00000000001100000000000000000000000000000000000000000000000000000000000000000000
00000000001111000000000000000000000000000000000000000000000000000000000000000000
00000000000000000000000000000000000000000000000000000000000000000000000000000000
00000000000000000000000000000000000000000000000000000000000000000000000000000000
00000000000000000000000000000000000000000000000000000000000000000000000000000000
00000000000000000000000000000000000000000000000000000000000000000000000000000000
00000000000000000000000000000000000000000000000000000000000000000000000000000000
00000000000000000000000000000000000000000000000000000000000000000000000000000000
00000000000000000000000000000000000000000000000000000000000000000000000000000000
00000000000000000000000000000000000000000000000000000000000000000000000000000000
00000000000000000000000000000000000000000000000000000000000000000000000000000000
00000000000000000000000000000000000000000000000000000000000000000000000000000000
00000000000000000000000000000000000000000000000000000000000000000000000000000000
00000000000000000000000000000000000000000000000000000000000000000000000000000000
00000000000000000000000000000000000000000000000000000000000000000000000000000000
00000000000000000000000000000000000000000000000000000000000000000000000000000000
00000000000000000000000000000000000000000000000000000000000000000000000000000000
00000000000000000000000000000000000000000000000000000000000000000000000000000000
00000000000000000000000000000000000000000000000000000000000000000000000000000000
00000000000000000000000000000000000000000000000000000000000000000000000000000000
