80 80
00000000000000000000000000000000000000000000000000000000000000000000000000000000
00000000000000000000000000000000000000000000000000000000000000000000000000000000
00000000000000000000000000000000000000000000000000000000000000000000000000000000
00000000000000000000000000000000000000000000000000000000000000000000000000000000
00000000000000000000000000000000000000000000000000000000000000000000000000000000
00000000000000000000000000000000000000000000000000000000000000000000000000000000
00000000000000000000000000000100000000000000000000000000000000000000000000000000
00000000000000000000000000000111100000000000000000000000000000000000000000000000
00000000000000000000001100000100000000000000000000000000000000000000000000000000
00000000001000000000111111001100000000000000000000000000000000000000000000000000
00000000001111110001110011101111011110000000000000000000000000000000000000000000
00000000011011100001110011110001111100000000000000000000000000000000000000000000
00000001110111100001110111110001000000000000000000000000000000000000000000000000
00000001000001100001111101110011100000000000000000000000000000000000000000000000
00000000000000110001111101100110000000000000010000100000000000000000000000000000
00000000000000010001111111100011000000000000111100100000000000000000000000000000
00000001000000011001111111000011000000000000111111100000000000000000000000000000
00000001100000011001111000000011100000000010111111000000000000000000000000000000
00000001100010011111111000000001100001000110010100100000000000000000000000000000
00000111111111111111111101111111111101101100011100111111000010000000000000000000
00000111111111111111111111111111111111111100111111111111100110000000000000000000
00001101101111111111112111111111110011111000111111101101110011000000000000000000
00000001100111111111111111111000110000011100111111111111110011100000000000000000
00001000110000111111111111111000110000001100000111111111111111000000000000000000
01111100111111110001111111111111111000001111110111111111100110000000000000000000
01111110011111111001111111111111111111011111111111111111100010000000000000000000
00111100001110011101111111111111111011111001111111111111100011000000000000000000
00111100001100011111101100011100110001000001111111111111100011100000000000000000
00111100011111111111101100001110100011000000111001111111110001100000000000000000
00000100111111111111110111000111010111100000011001111111111111100000000000000000
00000101111111111111110011100011011110111110111001111111111111000000000000000000
00000111111011111111110001100011011100000000010011111111111111000000000000000000
00000001100001111111110000000011011000000000000000001111001111100000000000000000
00000000000011110001111111010111111000000000000000000111000111110000000000000000
00000000000000110001111111110111111100000000000000001111000111111000000000000000
00000000000000010000111111110111110100000000000000000011100011011111000000000000
00000000000000011000111111000011100100000000000000000000110011000001000000000000
00000000000000001110001100000001000000000000000000000000011100000000000000000000
00000000000000000000011000000000000000000000000000000000000000000000000000000000
00000000000000000000110000000000000000000000000000000000000000000000000000000000
00000000000000000000100000000000000000000000000000000000000000000000000000000000
00000000000000000000000000000000000000000000000000000000000000000000000000000000
00000000000000000000000000000000000000000000000000000000000000000000000000000000
00000000000000000000000000000000000000000000000000000000000000000000000000000000
00000000000000000000000000000000000000000000000000000000000000000000000000000000
00000000000000000000000000000000000000000000000000000000000000000000000000000000
00000000000000000000000000000000000000000000000000000000000000000000000000000000
00000000000000000000000000000000000000000000000000000000000000000000000000000000
00000000000000000000000000000000000000000000000000000000000000000000000000000000
00000000000000000000000000000000000000000000000000000000000000000000000000000000
00000000000000000000000000000000000000000000000000000000000000000000000000000000
00000000000000000000000000000000000000000000000000000000000000000000000000000000
00000000000000000000000000000000000000000000000000000000000000000000000000000000
00000000000000000000000000000000000000000000000000000000000000000000000000000000
00000000000000000000000000000000000000000000000000000000000000000000000000000000
00000000000000000000000000000000000000000000000000000000000000000000000000000000
00000000000000000000000000000000000000000000000000000000000000000000000000000000
00000000000000000000000000000000000000000000000000000000000000000000000000000000
00000000000000000000000000000000000000000000000000000000000000000000000000000000
00000000000000000000000000000000000000000000000000000000000000000000000000000000
00000000000000000000000000000000000000000000000000000000000000000000000000000000
00000000000000000000000000000000000000000000000000000000000000000000000000000000
00000000000000000000000000000000000000000000000000000000000000000000000000000000
00000000000000000000000000000000000000000000000000000000000000000000000000000000
00000000000000000000000000000000000000000000000000000000000000000000000000000000
00000000000000000000000000000000000000000000000000000000000000000000000000000000
00000000000000000000000000000000000000000000000000000000000000000000000000000000
00000000000000000000000000000000000000000000000000000000000000000000000000000000
00000000000000000000000000000000000000000000000000000000000000000000000000000000
00000000000000000000000000000000000000000000000000000000000000000000000000000000
00000000000000000000000000000000000000000000000000000000000000000000000000000000
00000000000000000000000000000000000000000000000000000000000000000000000000000000
00000000000000000000000000000000000000000000000000000000000000000000000000000000
00000000000000000000000000000000000000000000000000000000000000000000000000000000
00000000000000000000000000000000000000000000000000000000000000000000000000000000
00000000000000000000000000000000000000000000000000000000000000000000000000000000
00000000000000000000000000000000000000000000000000000000000000000000000000000000
00000000000000000000000000000000000000000000000000000000000000000000000000000000
00000000000000000000000000000000000000000000000000000000000000000000000000000000
00000000000000000000000000000000000000000000000000000000000000000000000000000000
