80 80
00000000000000000000000000000000000000000000000000000000000000000000000000000000
00000000000000000000000000000000000000000000000000000000000000000000000000000000
00000000000000000000000000000000000000000000000000000000000000000000000000000000
00000000000000000000000000000000000000000000000000000000000000000000000000000000
00000000000000000000000000000000000000000000000000000000000000000000000000000000
00000000000000000000000000000000000000000000000000000000000000000000000000000000
00000000000000000000000000000000000000000000000000000000000000000000000000000000
00000000000000000000000000000000000000000000000000000000000000000000000000000000
00000000000000000000000000000000000000000000000000000000000000000000000000000000
00000000000000000000000000000000000000000000000000000000000000000000000000000000
00000000000000000000000000000000000000000000000000000000000000000000000000000000
00000000000000000000000000000000000000000000000000000000000000000000000000000000
00000000000000000000000000000000000000000000000000000000000000000000000000000000
00000000000000000000000000000000000000000000000000000000000000000000000000000000
00000000000000000000000000000000000000000000000000000000000000000000000000000000
00000000000000000000000000000000000000000000000000000000000000000000000000000000
00000000000000000000000000000000000000000000000000000000000000000000000000000000
00000000000000000000000000000000000000000000000000000000000000000000000000000000
00000000000000000000000000000000000000000000000000000000000000000000000000000000
00000000000000000000000000000000000000000000000000000000000000000000000000000000
00000000000000000000000000000000000000000000000000000000000000000000000000000000
00000000000000000000000000000000000000000000000000000000000000000000000000000000
00000000000000000000000000000000000000000000000000000000000000000000000000000000
00000000000000000000000001111100000000000000000000000000000000000000000000000000
00000000000000000000000001111000000000000000000000000000000000000000000000000000
00000000000000000000000001011000000000000000000000000000000000000000000000000000
00000000000000000000000001110000000000000000000000000000000000000000000000000000
00000000000000000000000001110000000000000000000000000000000000000000000000000000
00000000000000000000000001110000000000000000000000000000000000000000000000000000
00000000000000000000000001110000000000000000000000000000000000000000000000000000
00000000000000000000000011111111100000000000000000000000000000000000000000000000
00000000000000000000000011000000000000000000000000000000000000000000000000000000
00000000000000000000000110000100000000000000000000000000000000000000000000000000
00000000000000000000011100000111100000000000000000000000000000000000000000000000
00000000000000010000111110001110100100000000000000000000000000000000000000000000
00000000000000010001111111111111111110000000000000000000000000000000000000000000
00000000000000110001101100110001111100000000000000000000000000000000000000000000
00000000000001100000001100010000010000000000000000000000000000000000000000000000
00000000000111000000011011110000000000000000000000000000000000000000000000000000
01000000001111001100111001111110000100000000000000000000000000000000000000000000
01111110001101111111110001111111100100000000000000000000000000000000000000000000
00000011011001110001000011011111111100000000000000000000000000000000000000000000
00000011010001110000000011001110001100000000000000000000000000000000000000000000
00000011010001111000000111000000001110000000000000000000000000000000000000000000
00000110011111111000111111100111001110000000000000000000000000000000000000000000
00000110011111111111111111111111001100000000000000000000000000000000000000000000
00000100011111111111111111111111111110000000000000000000000000000000000000000000
00000110001110000011011111111111111111000000000000000000000000000000000000000000
00011111111111000010111111111111000111110000000000000000000000000000000000000000
00001101111111110111111111111111000110111000000000000000000000000000000000000000
00000111111111111101111111111111001110101000000000000000000000000000000000000000
00000111111111011001111111001111000110011000000000000000000000000000000000000000
00000011111110000001111110000000000100000000000000000000000000000000000000000000
01100011111100000001111110000000000100000011100000000000000000000000000000000000
00111111111100110001111111000000000100000111100000100000000000000000000000000000
01111111111111111001111011111111100100011110111000100000000000000000000000000000
01111111111111111101110001111101111100011000001100111000000000000000000000000000
00110001110011111100111000000000111111100010000111111000000000000000000000000000
00011001100111110000111110000000001111001111100011111100000000000000000000000000
00011111101111110000110011000010000110001110110011111110000000000000000000000000
00001111111111111001110011000010000100001110010011110011110000000000000000000000
00000111111000011111100011000010001100001110011111110001110000000000000000000000
00000011110000011111000010000111001100000010011111100000111100000000000000000000
00000011111001111000000110001111111111000011001011100000111110000000000000000000
00000111111111111000100110011111111111000011110001100001100110000000000000000000
01111111111111111001111111100111111111111111111000100001000110000000000000000000
01111111211111111011010100000110000010000011011000110001000011000000000000000000
00111111111111110010000000000011000000000010001000011000000000000000000000000000
00111111111101110001000000000001100000000010001000000000000000000000000000000000
01111111111100110001100000000001100000000000011000000000000000000000000000000000
01111110011100111001110000000011000000000000010000000000000000000000000000000000
01111110011100111001110000000000000000000000110000000000000000000000000000000000
00111100011111111111111000000000000000000001100000000000000000000000000000000000
00111101111111111111111100000000000000000001110000000000000000000000000000000000
01111111111100111001100000000000000000000001111100000000000000000000000000000000
01111111111100111001110000000000000000000000111100000000000000000000000000000000
00011111011100111001100000000000000000000000011000000000000000000000000000000000
00010010001110111001110000000000000000000000000000000000000000000000000000000000
00110000001110110011111100000000000000000000000000000000000000000000000000000000
00000000000000000000000000000000000000000000000000000000000000000000000000000000
