80 80
00000000000000000000000000000000000000000000000000000000000000000000000000000000
00000000000000000000000000000000000000000000000000000000000000000000000000000000
00000000000000000000000000000000000000000000000000000000000000000000000000000000
00000000000000000000000000000000000000000000000000000000000000000000000000000000
00000000000000000000000000000000000000000000000000000000000000000000000000000000
00000000000000000000000000000000000000000000000000000000000000000000000000000000
00000000000000000000000000000000000000000000000000000000000000000000000000000000
00000000000000000000000000000000000000000000000000000000000000000000000000000000
00000000000000000000000000000000000000000000000000000000000000000000000000000000
00000000000000000000000000000000000000000000000000000000000000000000000000000000
00000000000000000000000000000000000000000000000000000000000000000000000000000000
00000000000000000000000000000000000000000000000000000000000000000000000000000000
00000000000000000000000000000000000000000000000000000000000000000000000000000000
00000000000000000000000000000000000000000000000000000000000000000000000000000000
00000000000000000000000000000000000000000000000000000000000000000000000000000000
00000000000000000000000000000000000000000000000000000000000000000000000000000000
00000000000000000000000000000000000000000000000000000000000000000000000000000000
00000000000000000000000000000000000000000000000000000000000000000000000000000000
00000000000000000000000000000000000000000000000000000000000000000000000000000000
00000000000000000000000000000000000000000000000000000000000000000000000000000000
00000000000000000000000000000000000000000000000000000000000000000000000000000000
00000000000000000000000000000000000000000000000000000000000000000000000000000000
00000000000000000000000000000000000000000000000000000000000000000000000000000000
00000000000000000000000000000000000000000000000000000000000000000000000000000000
00000000000000000000000000000000000000000000000000000000000000000000000000000000
00000000000000000000000000000000000000000000000000000000000000000000000000000000
00000000000000000000000000000000000000000000000000000000000000000000000000000000
00000000000000000000000000000000000000000000000000000000000000000000000000000000
00000000000000000000000000000000000000000000000000000000000000000000000000000000
00000000000000000000000000000000000000000000000000000000000000000000000000000000
00000000000000000000000000000000000000000000000000000000000000000000000000000000
00000000000000000000000000000000000000000000000000000000000000000000000000000000
00000000000000000000000000000000000000000000000000000000000000000000000000000000
00000000000000000000000000000000000000000000000000000000000000000000000000000000
00000000000000000000000000000000000000000000000000000000000000000000000000000000
00000000000000000000000000000000000000000000000000000000000000000000000000000000
00000000000000000000000000000000000000000000000000000000000000000000000000000000
00000000000000000000000000000000000000000000000000000000000000000000000000000000
00000000000000000000000000000000000000000000000000000000000000000000000000000000
00000000000000010000000000000000000000000000000000000000000000000000000000000000
00000000000000110000000000000000000000000000000000000000000000000000000000000000
00000000000000011100000000000000000000000000000000000000000000000000000000000000
00000000000001111100001000000000000000000000000000000000000000000000000000000000
00000000000001111000001000000000000000000000000000000000000000000000000000000000
00000000000111110000011111000000000000000000000000000000000000000000000000000000
00000000001111111001111011000000000000000000000000000000000000000000000000000000
00000000011011111011001001100000000000000000000000000000000000000000000000000000
00000000110001110010001000010000000000000000000000000000000000000000000000000000
00000111110001000010001100010000000000000000000000000000000000000000000000000000
00000101111001111011101100111111000000000000000000000000000000000000000000000000
00000101111111111101111111111111000000000000000000000000000000000000000000000000
00000111111111111111111110000011000000000000000000000000000000000000000000000000
00000100111111100111001100000111100000000000000000000000000000000000000000000000
00000000111001110001100100001111100000000000000000000000000000000000000000000000
00001111111100110000110011011111100000000000000000000000000000000000000000000000
00001110011100111000110011111111000000000000000000000000000000000000000000000000
00001110011110111001100001111100000000000000000000000000000000000000000000000000
00000000001111111111100001111000000000000000000000000000000000000000000000000000
00000000011111111111000011110000000000000000000000000000000000000000000000000000
00001100011111111001111111110000000000000000000000000000000000000000000000000000
00001110011111111111111111111110000000000000000000000000000000000000000000000000
00000110011111111111111111111100000000000000000000000000000000000000000000000000
00010111111111011111101111111000000000000000000000000000000000000000000000000000
00011100111110011111100111111000000000000000000000000000000000000000000000000000
00001110111111111101111111111010011100000000000000000000000000000000000000000000
00000110111111111001111111111111111100001000000000000000000000000000000000000000
00000111111111110001111111110010110110011000000000000000000000000000000000000000
00001111111211110001111100000010110011001000000000000000000000000000000000000000
00001111111111110001111100011110000011001110000000000000000000000000000000000000
00000111111111110001111111111111011111001110000000000000000000000000000000000000
01111111111111111001111111111111001111111100000000000000000000000000000000000000
00011110001110111001111111100111101111111000000000000000000000000000000000000000
00010000000011110001110000100011111111111000000000000000000000000000000000000000
01110000000111110110000001111000011100000000000000000000000000000000000000000000
01011000001110111110111011111111011100001000000000000000000000000000000000000000
01001100011101111111111111111111101110011100000000000000000000000000000000000000
00000000011000011111101111111111100111110000000000000000000000000000000000000000
00000000111110011110001111100000110000000000000000000000000000000000000000000000
00000000001101111110001111110000011100000000000000000000000000000000000000000000
00000000000000000000000000000000000000000000000000000000000000000000000000000000
