80 80
00000000000000000000000000000000000000000000000000000000000000000000000000000000
00000000000000000000000000000000000000000000000000000000000000000000000000000000
00000000000000000000000000000000000000000000000000000000000000000000000000000000
00000000000000000000000000000000000000000000000000000000000000000000000000000000
00000000000000000000000000000000000000000000000000000000000000000000000000000000
00000000000000000000000000000000000000000000000000000000000000000000000000000000
00000000000000000000000000000000000000000000000000000000000000000000000000000000
00000000000000000000000000000000000000000000000000000000000000000000000000000000
00000000000000000000000000000000000000000000000000000000000000000000000000000000
00000000000000000000000000000000000000000000000000000000000000000000000000000000
00000000000000000000000000000000000000000000000000000000000000000000000000000000
00000000000000000000000000000000000000000000000000000000000000000000000000000000
00000000000000000000000000000000000000000000000000000000000000000000000000000000
00000000000000000000000000000000000000000000000000000000000000000000000000000000
00000000000000000000000000000000000000000000000000000000000000000000000000000000
00000000000000000000000000000000000000000000000000000000000000000000000000000000
00000000000000000000000000000000000000000000000000000000000000000000000000000000
00000000000000000000000000000000000000000000000000000000000000000000000000000000
00000000000000000000000000000000000000000000000000000000000000000000000000000000
00000000000000000000000000000000000000000000000000000000000000000000000000000000
00000000000000000000000000000000000000000000000000000000000000000000000000000000
00000000000000000000000000000000000000000000000000000000000000000000000000000000
00000000000000000000000000000000000000000000000000000000000000000000000000000000
00000000000000000000000000000000000000000000000000000000000000000000000000000000
00000000000000000000000000000000000000000000000000000000000000000000000000000000
00000000000000000000000000000000000000000000000000000000000000000000000000000000
00000000000000000000000000000000000000000000000000000000000000000000000000000000
00000000000000000000000000000000000000000000000000000000000000000000000000000000
00000000000000000000000000000000000000000000000000000000000000000000000000000000
00000000000000000000000000000000000000000000000000000000000000000000000000000000
00000000000000000000000000000000000000000000000000000000000000000000000000000000
00000000000000000000000000000000000000000000000000000000000000000000000000000000
00000000000000000000000000000000000000000000000000000000000000000000000000000000
00000000000000000000000000000000000000000000000000000000000000000000000000000000
00000000000000000000000000000000000000000000000000000000000000000000000000000000
00000000000000000000000000000000000000000000000000000000000000000000000000000000
00000000000000000000000000000000000000000000000000000000000000000000000000000000
00000000000000000000000000000000000000000000000000000000000000000000000000000000
00000000000000000000000000000000000000000000000000000000000000000000000001100000
00000000000000000000000000000000000000000000000000001111000000000000001011110000
00000000000000000000000000000000000000000000000000000111100000001111111110010000
00000000000000000000000000000000000000000000000000000001100000001111001110010000
00000000000000000000000000000000000000000000000000000000110000001101111011011000
00000000000000000000000000000000000000000000000001000001100111011111111011111000
00000000000000000000000000000000000000000000000001100001000111100111101101111000
00000000000000000000000000000000000000000000110000100001000111111111111001110000
00000000000000000000000000000000000000000110010000100011000111100101111001010000
00000000000000000000000000000000000000000011010001111111001111100000111101000000
00000000000000000000000000000000000000000011110000011001111111110000111110000000
00000000000000000000000000000000000000000011110100110001111111001000111100000000
00000000000000000000000000000000000000011110111101110001111111001111111100000000
00000000000000000000000000000000000000000000011111000011001111000111111000000000
00000000000000000000000000000000000000000000001110000011011111001111111000000000
00000000000000000000000000000000000000110000011110000111110111111111100000000000
00000000000000000000000000000000000011111000111111101111100111111111111000000000
00000000000000000000000000000000000001111100111001111111100111111110011000000000
00000000000000000000000000000000000000111100111000111111100111111000001000000000
00000000000000000000000000000000010000111111110000001111100011110000010000000000
00000000000000000000000000000000010000011111000100001111110001110000110000000000
00000000000000000000000000000000110011111111111111111111111111101100011000000000
00000000000000000000000000000111111111111111111111111112111111100100111100000000
00000000000000000000000000000001111111111111001111111111111111100111101000000000
00000000000000000000000000000000110111101110000111111111111111100111100000000000
00000000000000000000000000000000001110011100000000111011111111110100000000000000
00000000000000000000000000000000001100001110001000100011111111111100000000000000
00000000000000000000000000000000000110011111111000110111111111101100000000000000
00000000000000000000000000000000000011110010010000110111110001000110000000000000
00000000000000000000000000000000000000000000000000111111110000011100000000000000
00000000000000000000000000000000000000000000000000000000010000011000000000000000
00000000000000000000000000000000000000000000000000000100110000010000000000000000
00000000000000000000000000000000000000000000000011111111100000000000000000000000
00000000000000000000000000000000000000000000000010011100000000000000000000000000
00000000000000000000000000000000000000000000000000011100000000000000000000000000
00000000000000000000000000000000000000000000000000000110000000000000000000000000
00000000000000000000000000000000000000000000000000000000000000000000000000000000
00000000000000000000000000000000000000000000000000000000000000000000000000000000
00000000000000000000000000000000000000000000000000000000000000000000000000000000
00000000000000000000000000000000000000000000000000000000000000000000000000000000
00000000000000000000000000000000000000000000000000000000000000000000000000000000
00000000000000000000000000000000000000000000000000000000000000000000000000000000
