80 80
00000000000000000000000000000000000000000000000000000000000000000000000000000000
00000110000000000000000000000000000000000000000000000000000000000000000000000000
00000110000000000000000000000000000000000000000000000000000000000000000000000000
00111110000000000000000000000000000000000000000000000000000000000000000000000000
01111111111000000000000000000000000000000000000000000000000000000000000000000000
01111111111100000000100000000000000000000000000000000000000000000000000000000000
01111111101100000001100000000000000000000000000000000000000000000000000000000000
01111111100000000001100000000000000000000000000000000000000000000000000000000000
01111111100000000001110000000000000000000000000000000000000000000000000000000000
01111111111001100011100000000000000000000000000000000000000000000000000000000000
01111111111100111111100000000000000000000000000000000000000000000000000000000000
01111111111110011001110000000000000000000000000000000000000000000000000000000000
01111111111110000110110000000000000000000000000000000000000000000000000000000000
01111111111111111111110000000000000000000000000000000000000000000000000000000000
01111111111111111100110000000000000000000000000000000000000000000000000000000000
01111111111111111101100000000000000000000000000000000000000000000000000000000000
01121111111111111111100000000000000000000000000000000000000000000000000000000000
01111111111100011100000000000000000000000000000000000000000000000000000000000000
01111111111100001100000000000000000000000000000000000000000000000000000000000000
01111111111100011000000000000000000000000000000000000000000000000000000000000000
01111111111100110000000000000000000000000000000000000000000000000000000000000000
01111111111110110000000000000000000000000000000000000000000000000000000000000000
01111111111110100000000000000000000000000000000000000000000000000000000000000000
01111111111110010000000000000000000000000000000000000000000000000000000000000000
01111111111111011000000000000000000000000000000000000000000000000000000000000000
01111111111111110000000000000000000000000000000000000000000000000000000000000000
01111111111111110000000000000000000000000000000000000000000000000000000000000000
01111000111111100000000000000000000000000000000000000000000000000000000000000000
01111001111111100000000000000000000000000000000000000000000000000000000000000000
01111111111111110000000000000000000000000000000000000000000000000000000000000000
01111111111111110000000000000000000000000000000000000000000000000000000000000000
00001111111110010000000000000000000000000000000000000000000000000000000000000000
00000011110010000000000000000000000000000000000000000000000000000000000000000000
00000001100010000000000000000000000000000000000000000000000000000000000000000000
01000111000110000000000000000000000000000000000000000000000000000000000000000000
01111110011100000000000000000000000000000000000000000000000000000000000000000000
01111100110000000000000000000000000000000000000000000000000000000000000000000000
01111001000000000000000000000000000000000000000000000000000000000000000000000000
01110011000000000000000000000000000000000000000000000000000000000000000000000000
01110110000000000000000000000000000000000000000000000000000000000000000000000000
01111110000000000000000000000000000000000000000000000000000000000000000000000000
01001100000000000000000000000000000000000000000000000000000000000000000000000000
01111100000000000000000000000000000000000000000000000000000000000000000000000000
01111100000000000000000000000000000000000000000000000000000000000000000000000000
01111100000000000000000000000000000000000000000000000000000000000000000000000000
01111110000000000000000000000000000000000000000000000000000000000000000000000000
01101111000000000000000000000000000000000000000000000000000000000000000000000000
01100001000000000000000000000000000000000000000000000000000000000000000000000000
01110000000000000000000000000000000000000000000000000000000000000000000000000000
01111000000000000000000000000000000000000000000000000000000000000000000000000000
01101100000000000000000000000000000000000000000000000000000000000000000000000000
00100000000000000000000000000000000000000000000000000000000000000000000000000000
00000000000000000000000000000000000000000000000000000000000000000000000000000000
00000000000000000000000000000000000000000000000000000000000000000000000000000000
00000000000000000000000000000000000000000000000000000000000000000000000000000000
00000000000000000000000000000000000000000000000000000000000000000000000000000000
00000000000000000000000000000000000000000000000000000000000000000000000000000000
00000000000000000000000000000000000000000000000000000000000000000000000000000000
00000000000000000000000000000000000000000000000000000000000000000000000000000000
00000000000000000000000000000000000000000000000000000000000000000000000000000000
00000000000000000000000000000000000000000000000000000000000000000000000000000000
00000000000000000000000000000000000000000000000000000000000000000000000000000000
00000000000000000000000000000000000000000000000000000000000000000000000000000000
00000000000000000000000000000000000000000000000000000000000000000000000000000000
00000000000000000000000000000000000000000000000000000000000000000000000000000000
00000000000000000000000000000000000000000000000000000000000000000000000000000000
00000000000000000000000000000000000000000000000000000000000000000000000000000000
00000000000000000000000000000000000000000000000000000000000000000000000000000000
00000000000000000000000000000000000000000000000000000000000000000000000000000000
00000000000000000000000000000000000000000000000000000000000000000000000000000000
00000000000000000000000000000000000000000000000000000000000000000000000000000000
00000000000000000000000000000000000000000000000000000000000000000000000000000000
00000000000000000000000000000000000000000000000000000000000000000000000000000000
00000000000000000000000000000000000000000000000000000000000000000000000000000000
00000000000000000000000000000000000000000000000000000000000000000000000000000000
00000000000000000000000000000000000000000000000000000000000000000000000000000000
00000000000000000000000000000000000000000000000000000000000000000000000000000000
00000000000000000000000000000000000000000000000000000000000000000000000000000000
00000000000000000000000000000000000000000000000000000000000000000000000000000000
00000000000000000000000000000000000000000000000000000000000000000000000000000000
