80 80
00000000000000000000000000000000000000000000000000000000000000000000000000000000
00000000000000000000000000000000000000000000000000000000000000000000000000000000
00000000000000000000000000000000000000000000000000000000000000000000000000000000
00000000000000000000000000000000000000000000000000000000000000000000000000000000
00000000000000000000000000000000000000000000000000000000000000000000000000000000
00000000000000000000000000000000000000000000000000000000000000000000000000000000
00000000000000000000000000000000000000000000000000000000000000000000000000000000
00000000000000000000000000000000000000000000000000000000000000000000000000000000
00000000000000000000000000000000000000000000000000000000000000000000000000000000
00000000000000000000000000000000000000000000000000000000000000000000000000000000
00000000000000000000000000000000000000000000000000000000000000000000000000000000
00000000000000000000000000000000000000000000000000000000000000000000000000000000
00000000000000000000000000000000000000000000000000000000000000000000000000000000
00000000000000000000000000000000000000000000000000000000000000000000000000000000
00000000000000000000000000000000000000000000000000000000000000000000000000000000
00000000000000000000000000000000000000000000000000000000000000000000000000000000
00000000000000000000000000000000000000000000000000000000000000000000000000000000
00000000000000000000000000000000000000000000000000000000000000000000000000000000
00000000000000000000000000000000000000000000000000000000000000000000000000000000
00000000000000000000000000000000000000000000000000000000000000000000000000000000
00000000000000000000000000000000000000000000000000000000000000000000000000000000
00000000000000000000000000000000000000000000000000000000000000000000000000000000
00000000000000000000000000000000000000000000000000000000000000000000000000000000
00000000000000000000000000000000000000000000000000000000000000000000000000000000
00000000000000000000000000000000000000000000000000000000000000000000000000000000
00000000000000000000000000000000000000000000000000000000000000000000000000000000
00000000000000000000000000000000000000000000000000000000000000000000000000000000
00000000000000000000000000000000000000000000000000000000000000000000000000000000
00000000000000000000000000000000000000000000000000000000000000000000000000000000
00000000000000000000000000000000000000000000000000000000000000000000000000000000
00000000000000000000000000000000000000000000000000000000000000000000000000000000
00000000000000000000000000000000000000000000000000000000000000000000000000000000
00000000000000000000000000000000000000000000000000000000000000000000000000000000
00000000000000000000000000000000000000000000000000000000000000000000000000000000
00000000000000000000000000000000000000000000000000000000000000000000000000000000
00000000000000000000000000000000000000000000000000000000000000000000000000000000
00000000000000000000000000000000000000000000000000000000000000000000000000000000
00000000000000000000000000000000000000000000000000000000000000000000000000000000
00000000000000000000000000000000000000000000000000000000000000000000000000000000
00000000000000000000000000000000000000000000000000000000000000000000000000000000
00000000000000000000000000000000000000000000000000100000000000000000000000000000
00000000000000000000000000000000000000000000000000100000000000000000000000000000
00000000000000000000000000000000000000000000000000100000000000000000000000000000
00000000000000000000000000000000000000000000000000100000000000000000000000000000
00000000000000000000000000000000000000000000000000100000000000001000001110001000
00000000000000000000000000000000000000000000000000100000000000001110011111111000
00000000000000000000000000000000000000000000000000100000000000000011111001100000
00000000000000000000000000000000000000000000000000110000000000000001111100000000
00000000000000000000000000000000000000000000000000011000000000000000011000000000
00000000000000000000000000000000000000000000000000011110000011111110011000000000
00000000000000000000000000000000000000000000000011111111100111011111011100000000
00000000000000000000000000000000000000000000000011101001111111001111001100000000
00000000000000000000000000000000000000000000000011110000111111100111001110000000
00000000000000000000000000000000000000000000000001100000111001100111001111110000
00000000000000000000000000000000000000000000000001100001111111111110001111110000
00000000000000000000000000000000000000000000000000110011111111111110011111111000
00000000000000000000000000000000000000000000100000111111111111111110011111111000
00000000000000000000000000000000000000000011100000111111111111111111111111111000
00000000000000000000000000000000000000000001111111111001111111111111111111111100
00000000000000000000000000000000000000000001111111111101111111111111111100111110
00000000000000000000000000000000000000111111111111111111111111111121111110111110
00000000000000000000000000000000000001100011111100001111000111111111111111111110
00000000000000000000000000000000000001000001111100000110001111111111111110111110
00000000000000000000000000000000000000000000111100000111111111011111111100111110
00000000000000000000000000000000000000000001111100001111100111001111111100111000
00000000000000000000000000000000000000000000111001111111100111001111111111111000
00000000000000000000000000000000000000000000111000000111100110001111101111111000
00000000000000000000000000000000000000000000010000000000011110011111000011111000
00000000000000000000000000000000000000000000000000111000011100111110000000011100
00000000000000000000000000000000000000000000000000111100111111111100001100011000
00000000000000000000000000000000000000000000000000100111111111101100011111111000
00000000000000000000000000000000000000000000000000100010000011000110011001110000
00000000000000000000000000000000000000000000000000100000000000000011100000000000
00000000000000000000000000000000000000000000000001100000001000000011000000000000
00000000000000000000000000000000000000000000000011100000001110000111111000000000
00000000000000000000000000000000000000000000000111110000000111011110011000000000
00000000000000000000000000000000000000000000000100110000000011111000011000000000
00000000000000000000000000000000000000000000000011110000000011110000110000000000
00000000000000000000000000000000000000000000000010111000000110000000110000000000
00000000000000000000000000000000000000000000000000000000000000000000000000000000
