80 80
00000000000000000000000000000000000000000000000000000000000000000000000000000000
00000000000000000000000000000000000000000000000000000000000000000000000000000000
00000000000000000000000000000000000000000000000000000000000000000000000000000000
00000000000000000000000000000000000000000000000000000000000000000000000000000000
00000000000000000000000000000000000000000000000000000000000000000000000000000000
00000000000000000000000000000000000000000000000000000000000000000000000000000000
00000000000000000000000000000000000000000000000000000000000000000000000000000000
00000000000000000000000000000000000000000000000000000000000000000000000000000000
00000000000000000000000000000000000000000000000000000000000000000000000000000000
00000000000000000000000000000000000000000000000000000000000000000000000000000000
00000000000000000000000000000000000000000000000000000000000000000000000000000000
00000000000000000000000000000000000000000000000000000000000000000000000000000000
00000000000000000000000000000000000000000000000000000000000000000000000000000000
00000000000000000000000000000000001000000000000000000000000000000000000000000000
00000000000000000000000000000000011100000000000000000000000000000000000000000000
00000000000000000000000000000000011110111100000000000000000000000000000000000000
00000000000000000000000000000000011111111000000000000000000000000000000000000000
00000000000000000000000000000000001011111000000000000000000000000000000000000000
00000000000000000000000000000000000101111100011100000000000000000000000000000000
00000000000000000000000000000000000111111100011110000000000000000000000000000000
00000000000000000000000000000000001110111100010011100000000000000000000000000000
00000000000000000000000000000000000100011000110100000000000000000000000000000000
00000000000000000000000000000000000100011111110100000000000000000000000000000000
00000000000000000000000000000000000000001111111100010000000000000000000000000000
00000000000000000000000000000000000000001000111110110000000000000000000000000000
00000000000000000000000000000000000000001001111111100000000000000000000000000000
00000000000000000000000000000000000000001000111111100000000000000000000000000000
00000000000000000000000000000000000000000000011111111000000000000000000000000000
00000000000000000000000000000000000000000000010001110000110000000000000000000000
00000000000000000000000000011100000100000000110001100001111100000000000000000000
00000000000000000000000011111111001111111110010001110011100111000000000000000000
00000000000000000000000000011011001110010010011001110011100000000000000000000000
00000000000000000000000000001001111111000011011111111111111000000000000000000000
00000000000000000000000000001111111111110001111111111111111100000000000000000000
00000000000000000000000000000111111111111001111111211111101111000000000000000000
00000000000000000011110000000111111111111111111111111111100111000000000000000000
00000000000000000011000000000111111111111111111111111111110111000000000000000000
00000000000000000110000000000111111111111111001111101100001111000000000000000000
00000000000000001110000000000011000111111111000011001100000001100000000000000000
00000000000000011111100000000011000111111111110011110000000001000000000000000000
00000000000000011011110000000010011110011110111001110000000011000000000000000000
00000000000000110011110000000000011000011000011000000000000000000000000000000000
00000000000000100011110000100000010000000000001100000000000000000000000000000000
00000000000000000001111000100000010000000000001000000000000000000000000000000000
00000000000000000001111001100000011000000000000000000000000000000000000000000000
00000000000000000001111111111111111100000000000000000000000000000000000000000000
00000000000000000001111111111111100000000000000000000000000000000000000000000000
00000000000000000000111111111111100000000000000000000000000000000000000000000000
00000000000000000000100011111111000000000000000000000000000000000000000000000000
00000000000000000000000011111111000000000000000000000000000000000000000000000000
00000000000000000000000011111111000000000000000000000000000000000000000000000000
00000000000000000000000011111111111000000000000000000000000000000000000000000000
00000000000000000000000001111001100000000000000000000000000000000000000000000000
00000000000000000000000011111011100000000000000000000000000000000000000000000000
00000000000000000000000011111111110010001000000000000000000000000000000000000000
00000000000000000000000001111111111111111100000000000000000000000000000000000000
00000000000000000000000001111111111100000000000000000000000000000000000000000000
00000000000000000000000000111111111111110000000000000000000000000000000000000000
00000000000000000000000000111111111111111000000000000000000000000000000000000000
00000000000000000000000000111111111111111000000000000000000000000000000000000000
00000000000000000000000011111111111111111100000000000000000000000000000000000000
00000000000000000000000000000011111111101110000000000000000000000000000000000000
00000000000000000000000000000000001111000111100000000000000000000000000000000000
00000000000000000000000000000000001110000110000000000000000000000000000000000000
00000000000000000000000000000000011110001110000000000000000000000000000000000000
00000000000000000000000000000000000110011100000000000000000000000000000000000000
00000000000000000000000000000000000110011000000000000000000000000000000000000000
00000000000000000000000000000000000010011000000000000000000000000000000000000000
00000000000000000000000000000000000001110000000000000000000000000000000000000000
00000000000000000000000000000000000001000000000000000000000000000000000000000000
00000000000000000000000000000000000000000000000000000000000000000000000000000000
00000000000000000000000000000000000000000000000000000000000000000000000000000000
00000000000000000000000000000000000000000000000000000000000000000000000000000000
00000000000000000000000000000000000000000000000000000000000000000000000000000000
00000000000000000000000000000000000000000000000000000000000000000000000000000000
00000000000000000000000000000000000000000000000000000000000000000000000000000000
00000000000000000000000000000000000000000000000000000000000000000000000000000000
00000000000000000000000000000000000000000000000000000000000000000000000000000000
00000000000000000000000000000000000000000000000000000000000000000000000000000000
00000000000000000000000000000000000000000000000000000000000000000000000000000000
