80 80
00000000000000000000000000000000000000000000000000000000000000000000000000000000
00000000000000000000000000000000000000000000000000000000000000000000000000000000
00000000000000000000000000000000000000000000000000000000000000000000000000000000
00000000000000000000000000000000000000000000000000000000000000000000000000000000
00000000000000000000000000000000000000000000000000000000000000000000000000000000
00000000000000000000000000000000000000000000000000000000000000000000000000000000
00000000000000000000000000000000000000000000000000000000000000000000000000000000
00000000000000000000000000000000000000000000000000000000000000000000000000000000
00000000000000000000000000000000000000000000000000000000000000000000000000000000
00000000000000000000000000000000000000000000000000000000000000000000000000000000
00000000000000000000000000000000000000000000000000000000000000000000000000000000
00000000000000000000000000000000000000000000000000000000000000000000000000000000
00000000000000000000000000000000000000000000000000000000000000000000000000000000
00000000000000000000000000000000000000000000000000000000000000000000000000000000
00000000000000000000000000000000000000000000000000000000000000000000000000000000
00000000000000000000000000000000000000000000000000000000000000000000000000000000
00000000000000000000000000000000000000000000000000000000000000000000000000000000
00000000000000000000000000000000000000000000000000000000000000000000000000000000
00000000000000000000000000000000000000000000000000000000000000000000000000000000
00000000000000000000000000000000000000000000000000000000000000000000000000000000
00000000000000000000000000000000000000000000000000000000000000000000000000000000
00000000000000000000000000000000000000000000000000000000000000000000000000000000
00000000000000000000000000000000000000000000000000000000000000000000000000000000
00000000000000000000000000000000000000000000000000000000000000000000000000000000
00000000000000000000000000000000000000000000000000000000000000000000000000000000
00000000000000000000000000000000000000000000000000000000000000000000000000000000
00000000000000000000000000000000000000000000000000000000000000000000000000000000
00000000000000000000000000000000000000000000000000000000000000000000000000000000
00000000000000000000000000000000000000000000000000000000000000000000000000000000
00000000000000000000000000000000000000000000000000000000000000000000000000000000
00000000000000010000000000000000000000000000000000000000000000000000000000000000
00000000000000011000000000000000000000000000000000000000000000000000000000000000
00000000000000001111000000000000000000000000000000000000000000000000000000000000
00000000000001111111100000000000000000000000000000000000000000000000000000000000
00000000000000111001100000000000000000000000000000000000000000000000000000000000
00000111111100111000100000000000000000000000000000000000000000000000000000000000
00000010000111111000110000000000000000000000000000000000000000000000000000000000
00000000001111111000010000000000000000000000000000000000000000000000000000000000
00000000011111111000011110000000000000000000000000000000000000000000000000000000
00001100011001111000011111000000000000000000000000000000000000000000000000000000
00001110011111111001111111000000000000000000000000000000000000000000000000000000
00001110000111111111000100000000000000000000000000000000000000000000000000000000
00000110000110000110000100000000000000000000000000000000000000000000000000000000
00000100001100000110000100000000000000000000000000000000000000000000000000000000
00000100001000001110001000000000000000000000000000000000000000000000000000000000
00000100001000111111111000000000000000000000000000000000000000000000000000000000
00000110001101111111111000000000000000000000000000000000000000000000000000000000
01111110001111111000111000000000000000000000000000000000000000000000000000000000
01001111111000110000110000000000000000000000000000000000000000000000000000000000
00000100011000110000100000000000000000000000000000000000000000000000000000000000
00000100001000111001100000000000000000000000000000000000000000000000000000000000
01001100001100011000100000000000000000000000000000000000000000000000000000000000
01111100001110000000000000000000000000000000000000000000000000000000000000000000
01000000001111100000000000000000000000000000000000000000000000000000000000000000
01000111111111110000000000000000000000000000000000000000000000000000000000000000
01001111111111111000000000000000000000000000000000000000000000000000000000000000
00001110111111111000000000000000000000000000000000000000000000000000000000000000
00001111111111110000000000000000000000000000000000000000000000000000000000000000
00011111111111100000000000000000000000000000000000000000000000000000000000000000
01011110011111110000000000000000000000000000000000000000000000000000000000000000
01111111011111111111110000000000000000000000000000000000000000000000000000000000
01111111111111001111000000000000000000000000000000000000000000000000000000000000
01110111111111000000000000000000000000000000000000000000000000000000000000000000
01111111121111000000001000000000000000000000000000000000000000000000000000000000
01111111111111110000011000000000000000000000000000000000000000000000000000000000
01111111111111111111110000000000000000000000000000000000000000000000000000000000
01111111111110011111100000000000000000000000000000000000000000000000000000000000
01111111111100000111100000000000000000000000000000000000000000000000000000000000
00011111101100001111100000000000000000000000000000000000000000000000000000000000
00001111111000011100100000000000000000000000000000000000000000000000000000000000
00001111111100111001110000010000000000000000000000000000000000000000000000000000
00000111111100110000100000111000000000000000000000000000000000000000000000000000
00000111111111011111110001110000000000000000000000000000000000000000000000000000
00000011111111011101111111100000000000000000000000000000000000000000000000000000
00000011111011010000100010000000000000000000000000000000000000000000000000000000
00001110001000110000100000000000000000000000000000000000000000000000000000000000
00000000000000000000000000000000000000000000000000000000000000000000000000000000
00000000000000000000000000000000000000000000000000000000000000000000000000000000
00000000000000000000000000000000000000000000000000000000000000000000000000000000
00000000000000000000000000000000000000000000000000000000000000000000000000000000
