80 80
00000000000000000000000000000000000000000000000000000000000000000000000000000000
00000000000000000000000000000000000000000000000000000000000000000000000000000000
00000000000000000000000000000000000000000000000000000000000000000000000000000000
00000000000000000000000000000000000000000000000000000000000000000000000000000000
00000000000000000000000000000000000000000000000000000000000000000000000000000000
00000000000000000000000000000000000000000000000000000000000000000000000000000000
00000000000000000000000000000000000000000000000000000000000000000000000000000000
00000000000000000000000000000000000000000000000000000000000000000000000000000000
00000000000000000000000000000000000000000000000000000000000000000000000000000000
00000000000000000000000000000000000000000000000000000000000000000000000000000000
00000000000000000000000000000000000000000000000000000000000000000000000000000000
00000000000000000000000000000000000000000000000000000000000000000000000000000000
00000000000000000000000000000000000000000000000000000000000000000000000000000000
00000000000000000000000000000000000000000000000000000000000000000000000000000000
00000000000000000000000000000000000000000000000000000000000000000000000000000000
00000000000000000000000000000000000000000000000000000000000000000000000000000000
00000000000000000000000000000000000000000000000000000000000000000000000000000000
00000000000000000000000000000000000000000000000000000000000000000000000000000000
00000000000000000000000000000000000000000000000000000000000000000000000000000000
00000000000000000000000000000000000000000000000000000000000000000000000000000000
00000000000000000000000000000000000000000000000000000000000000000000000000000000
00000000000000000000000000000000000000000000000000000000000000000000000000000000
00000000000000000000000000000000000000000000000000000000000000000000000000000000
00000000000000000000000000000000000000000000000000000000000000000000000000000000
00000000011000000000000000000000000000000000000000000000000000000000000000000000
00000000011000000000000000000000000000000000000000000000000000000000000000000000
00000000001100000000000000000000000000000000000000000000000000000000000000000000
00000000001100000000000000000000000000000000000000000000000000000000000000000000
00000010011100000000000000000000000000000000000000000000000000000000000000000000
00000110011100000000000000000000000000000000000000000000000000000000000000000000
00001110011100000000000000000000000000000000000000000000000000000000000000000000
00001110011100000000000000000000000000000000000000000000000000000000000000000000
00001111011110000000000000000000000000000000000000000000000000000000000000000000
00011111111111000000000000000000000000000000000000000000000000000000000000000000
01111111111101110000110000000000000000000000000000111110010000000000000000000000
01001110011100111001110000000000000000000000000011110011110000000000000000000000
00001110001110011111100000000000000000000000000011110000000000000000000000000000
00000111000011011111000000000000000000000001100000010000000000000000000000000000
01100011000011111111000100110000000000000000100000010000111000000000000000000000
01111111110011111111101101100000000000000000110000010001101100000000001000000000
01111111111111111111111111000000000000000000111001110001000111000000001000000000
01100001100111111110111011000000000000000000011111100001000001000000001100000000
00100000100000111110000010100000000000000000000111100011000000100000011110000000
00000000100000000111110011110000000001000000000011111111110001110011111011000000
00001000011111111111111111100010000001101001000111100011000011111111111001000000
00001110111111111111111111100111000111111101111111111011101111001111111111111000
00000111111111111111111111100011101111101111111110011111101110001111100110000000
00001110111111111111111100111011111111001111110110001111111110000000000010000000
00001100011111110001110000111111011110001111111110000011111110000000000111000000
00001100011111110011111001110111001110011111111011100001111110000010001001110000
00001110011111111111111111110110001110001111111001110011100111001111001000110000
00000011011111011111111111111111001111001111111000111111000111111111001000011000
00000001111110000000000000001111111111111111111000011111001111111111111111001000
00000000011111111000000000001111011111111111111111000011110111111111001110000000
00000000001100111111100011111110001110111111111111100011100011111110001000000000
00000000011100111111111111111111001110111111111111110011100111011110001000000000
00000000111000111101111111111011111110111111111101110011100110000000011000000000
00000000011100011110011111110000111111111111111100111111111100000000110000000000
00000000011010001111111111111000011111111111111111111111111000000001100000000000
00000000011011111111111111111111111111111111111111111111111000011111000000000000
00000000001011111111111111111111111111111111111111110111111111111111000000000000
00000000000100110111111111100111111111111211111111110111111110011110000000000000
00000000000100111111111111110011111111111111111111111111111111110010000000000000
00000000000111111100111111111111111111111111111111111111111110000000000000000000
00000000000100111100111111111111111111111111111111111001101110000000000000000000
00000000000000111101111111111111111111111111111111110001000010000000000000000000
00000000000000011011100111111111111111011111111111100011000000000000000000000000
00000000000000000111000100011111101111111111111111000111100000000000000000000000
00000000000000000001000110001011111111111111111110000101110000000000000000000000
00000000000000000001100011011111111111111111111111011101010000000000000000000000
00000000000000000001110011111111111111111111111111111001100000000000000000000000
00000000000000000000110001111111111110011111111111000000000000000000000000000000
00000000000000000000111001111111111100011111111110000000000000000000000000000000
00000000000000000000011111111111111100011100111000000000000000000000000000000000
00000000000000000000111011111111001110011000110000000000000000000000000000000000
00000000000000011111111001111110001110011000010000000000000000000000000000000000
00000000000000000111101101111110001100001000011000000000000000000000000000000000
00000000000000000111111000111110000000111100001000000000000000000000000000000000
00000000000000000000111000011110000000111111111100000000000000000000000000000000
00000000000000000000000000000000000000000000000000000000000000000000000000000000
