80 80
00000000000000000000000000000000000000000000000000000000000000000000000000000000
00000000000000000000000000000000000000000000000000000000000000000000000000000000
00000000000000000000000000000000000000000000000000000000000000000000000000000000
00000000000000000000000000000000000000000000000000000000000000000000000000000000
00000000000000000000000000000000000000000000000000000000000000000000000000000000
00000000000000000000000000000000000000000000000000000000000000000000000000000000
00000000000000000000000000000000000000000000000000000000000000000000000000000000
00000000000000000000000000000000000000000000000000000000000000000010000000000000
00000000000000000000000000000000000000000000000000000000000000000110000000000000
00000000000000000000000000000000000000000000000000000000000000000100000000000000
00000000000000000000000000000000000000000000000000000000000000000100000000000000
00000000000000000000000000000000000000000000000000000000000000000100000000000000
00000000000000000000000000000000000000000000000000000000000000000110000000000000
00000000000000000000000000000000000000000000000000000000000000000010000001110000
00000000000000000000000000000000000000000000000000000000000000000111111001110000
00000000000000000000000000000000000000000000000000000000000111001111111100110000
00000000000000000000000000000000000000000000000000000000000011000001111100011000
00000000000000000000000000000000000000000000000000000000000111000000111110111110
00000000000000000000000000000000000000000000000000000010000111000001111111111100
00000000000000000000000000000000000000000000000000000011100110100011011111111000
00000000000000000000000000000000000000000000000000100011101111111110011111111000
00000000000000000000000000000000000000000000000000111111110011111100011101110000
00000000000000000000000000000000000000000000000001111111110001110000111000000000
00000000000000000000000000000000000000000000000011111111110001001111111100000000
00000000000000000000000000000000000000000000000000110011110011001111111001100000
00000000000000000000000000000000000000000000000000110011100111001111011111110000
00000000000000000000000000000000000000000000000001100111100011001111001111011000
00000000000000000000000000000000000000000000000000000011110010000011001110001100
00000000000000000000000000000000000000000000000000000011110011000001111111001110
00000000000000000000000000000000000000000000000000111111111111000111111111111000
00000000000000000000000000000000000000000000000000100011111111001111111211111000
00000000000000000000000000000000000000000000000001100001111111001111111111111000
00000000000000000000000000000000000000000000000001100000000111110001111111111000
00000000000000000000000000000000000000000000000000100000000011111111111111000000
00000000000000000000000000000000000000000000000000110000100011111111011001001000
00000000000000000000000000000000000000000000000001110011111111111111011101111110
00000000000000000000000000000000000000000000000001000010011110111111001100100110
00000000000000000000000000000000000000000000000000000000011000010011111110001100
00000000000000000000000000000000000000000000000000000000110000010000011111111000
00000000000000000000000000000000000000000000000000000000000000011100001111110000
00000000000000000000000000000000000000000000000000000000000111111110001111110000
00000000000000000000000000000000000000000000000000000000000000100010011011011000
00000000000000000000000000000000000000000000000000000000000000100001110011011000
00000000000000000000000000000000000000000000000000000000000000100001110011011100
00000000000000000000000000000000000000000000000000000000000000100011111110110000
00000000000000000000000000000000000000000000000000000000000111101111111100010000
00000000000000000000000000000000000000000000000000000000000000011000011100010000
00000000000000000000000000000000000000000000000000000000000000010000011100000000
00000000000000000000000000000000000000000000000000000000000000010000011100000000
00000000000000000000000000000000000000000000000000000000000000000000111100000000
00000000000000000000000000000000000000000000000000000000000000000111111100000000
00000000000000000000000000000000000000000000000000000000000000000011111100000000
00000000000000000000000000000000000000000000000000000000000000000001111100000000
00000000000000000000000000000000000000000000000000000000000000000011011111100000
00000000000000000000000000000000000000000000000000000000000000000110001000110000
00000000000000000000000000000000000000000000000000000000000000000100001000010000
00000000000000000000000000000000000000000000000000000000000000000100000000010000
00000000000000000000000000000000000000000000000000000000000000000110000000000000
00000000000000000000000000000000000000000000000000000000000000000010000000000000
00000000000000000000000000000000000000000000000000000000000000000111000000000000
00000000000000000000000000000000000000000000000000000000000000000100000000000000
00000000000000000000000000000000000000000000000000000000000000000100000000000000
00000000000000000000000000000000000000000000000000000000000000000000000000000000
00000000000000000000000000000000000000000000000000000000000000000000000000000000
00000000000000000000000000000000000000000000000000000000000000000000000000000000
00000000000000000000000000000000000000000000000000000000000000000000000000000000
00000000000000000000000000000000000000000000000000000000000000000000000000000000
00000000000000000000000000000000000000000000000000000000000000000000000000000000
00000000000000000000000000000000000000000000000000000000000000000000000000000000
00000000000000000000000000000000000000000000000000000000000000000000000000000000
00000000000000000000000000000000000000000000000000000000000000000000000000000000
00000000000000000000000000000000000000000000000000000000000000000000000000000000
00000000000000000000000000000000000000000000000000000000000000000000000000000000
00000000000000000000000000000000000000000000000000000000000000000000000000000000
00000000000000000000000000000000000000000000000000000000000000000000000000000000
00000000000000000000000000000000000000000000000000000000000000000000000000000000
00000000000000000000000000000000000000000000000000000000000000000000000000000000
00000000000000000000000000000000000000000000000000000000000000000000000000000000
00000000000000000000000000000000000000000000000000000000000000000000000000000000
00000000000000000000000000000000000000000000000000000000000000000000000000000000
