80 80
00000000000000000000000000000000000000000000000000000000000000000000000000000000
00000000000000000000000000000000000000000000000000000000000000000000000000000000
00000000000000000000000000000000000000000000000000000000000000000000000000000000
00000000000000000000000000000000000000000000000000000000000000000000000000000000
00000000000000000000000000000000000000000000000000000000000000000000000000000000
00000000000000000000000000000000000000000000000000000000000000000000000000000000
00000000000000000000000000000000000000000000000000000000000000000000000000000000
00000000000000000000000000000000000000000000000000000000000000000000000000000000
00000000000000000000000000000000000000000000000000000000000000000000000000000000
00000000000000000000000000000000000000000000000000000000000000000000000000000000
00000000000000000000000000000000000000000000000000000000000000000000000000000000
00000000000000000000000000000000000000000000000000000000000000000000000000000000
00000000000000000000000000000000000000000000000000000000000000000000000000000000
00000000000000000000000000000000000000000000000000000000000000000000000000000000
00000000000000000000000000000000000000000000000000000000000000000000000000000000
00000000000000000000000000000000000000000000000000000000000000000000000000000000
00000000000000000000000000000000000000000000000000000000000000000000000000000000
00000000000000000000000000000000000000000000000000000000000000000000000000000000
00000000000000000000000000000000000000000000000000000000000000000000000000000000
00000000000000000000000000000000000000000000000000000000000000000000000000000000
00000000000000000000000000000000000000000000000000000000000000000000000000000000
00000000000000000000000000000000000000000000000000000000000000000000000000000000
00000000000000000000000000000000000000000000000000000000000000000000000000000000
00000000000000000000000000000000000000000000000000000000000000000000000000000000
00000000000000000000000000000000000000000000000000000000000000000000000000000000
00000000000000000000000000000000000000000000000000000000000000000000000000000000
00000000000000000000000000000000000000000000000000000000000000000000000000000000
00000000000000000000000000000000000000000000000000000000000000000000000000000000
00000000000000000000000000000000000000000000000000000000000000000000000000000000
00000000000000000000000000000000000000000000000000000000000000000000000000000000
00000000000000000000000000000000000000000000000000000000000000000000000000000000
00000000000000000000000000000000000000000000000000000000000000000000000000000000
00000000000000000000000000000000000000000000000000000000000000000000000000000000
00000000000000000000000000000000000000000000000000000000000000000000000000000000
00000000000000000000000000000000000000000000000000000000000000000000000000000000
00000000000000000000000000000000000000000000000000000000000000000000000000000000
00000000000000000000000000000000000000000000000000000000000000000000000000000000
00000000000000000000000000000000000000000000000000000000000000000000000000000000
00000000000000000000000000000000000000000000000000000000000000000001000000000000
00000000000000000000000000000000000000000000000000000000000000001101100110000000
00000000000000000000000000000000000000000000000000000000000000001111111100000000
00000000000000000000000000000000000000000000000000000000000000000111110000000000
00000000000000000000000000000000000000000000000000000000000000000111000000000000
00000000000000000000000000000000000000000000000000000000000000000110000011000000
00000000000000000000000000000000000000000000000000000000000000000110011111100000
00000000000000000000000000000000000000000000000000000000000000001110011111111110
00000000000000000000000000000000000000000000000000000000000000001100011111011110
00000000000000000000000000000000000000000000000000000000000000011100111111111100
00000000000000000000000000000000000000000000000000000000000000111111111111111100
00000000000000000000000000000000000000000000000010000000111011111110011110110000
00000000000000000000000000000000000000000000000011100011111111111110011110111000
00000000000000000000000000000000000000000000000110000010000111011110011100011100
00000000000000000000000000000000000000000000000100000110000011111000001100011100
00000000000000000000000000000000000000000000001100000001100011110000000000111110
00000000000000000000000000000000000000000000011000000001100111111110011101111110
00000000000000000000000000000000000000000000011000000011100111111111111110111110
00000000000000000000000000000000000000000000110000000011000011111111111111011000
00000000000000000000000000000000000000000111100000000110000111100000100011111000
00000000000000000000000000000000000000011111000000111111001110000001100001111000
00000000000000000000000000000000000000011011100000111111101110001111111000111100
00000000000000000000000000000000000000011111111000110111110111001110011100111110
00000000000000000000000000000000000000001111011001100000111111001110001100111110
00000000000000000000000000000000000000000111111001000000011111001111100011111110
00000000000000000000000000000000000000001110011011000000011101111100000011011100
00000000000000000000000000000000000111111100011111100001111111011100000111011000
00000000000000000000000000000000000110011100111111110001111111000110111111111000
00000000000000000000000000000000001100011111100100110011000000000111110011110000
00000000000000000000000000000000000111000011000111111110000000000011100011000000
00000000000000000000000000000000000011100001011111111100000000011111001111000000
00000000000000000000000000000000000011110000011100110111110000111111001111100000
00000000000000000000000000000000001111111110111111110111111111100111111001111110
00000000000000000000000000000000011001100100112111100111100000001101101000111110
00000000000000000000000000000000000001000000111110000111000000001100000000111000
00000000000000000000000000000000000001000011111110000111100000001000000001111000
00000000000000000000000000000100000011000100010011000111100000000000010010011000
00000000000000000000000000001111111111111100010001111111000000000000011110010000
00000000000000000000000000001111000000011000010000111111100000000000000111110000
00000000000000000000000000001000000000011101110000001100100000000000000000000000
00000000000000000000000000001000000000011111110000011000000000000000000000000000
00000000000000000000000000000000000000000000000000000000000000000000000000000000
