80 80
00000000000000000000000000000000000000000000000000000000000000000000000000000000
00000000000000000000000000000000000000000000000000000000000000000000000000000000
00000000000000000000000000000000000000000000000000000000000000000000000000000000
00000000000000000000000000000000000000000000000000000000000000000000000000000000
00000000000000000000000000000000000000000000000000000000000000000000000000000000
00000000000000000000000000000000000000000000000000000000000000000000000000000000
00000000000000000000000000000000000000000000000000000000000000000000000000000000
00000000000000000000000000000000000000000000000000000000000000000000000000000000
00000000000000000000000000000000000000000000000000000000000000000000000000000000
00000000000000000000000000000000000000000000000000000000000000000000000000000000
00000000000000000000000000000000000000000000000000000000000000000000000000000000
00000000000000000000000000000000000000000000000000000000000000000000000000000000
00000000000000000000000000000000000000000000000000000000000000000000000000000000
00000000000000000000000000000000000000000000000000000000000000000000000000000000
00000000000000000000000000000000000000000000000000000000000000000000000000000000
00000000000000000000000000000000000000000000000000000000000000000000000000000000
00000000000000000000000000000000000000000000000000000000000000000000000000000000
00000000000000000000000000000000000000000000000000000000000000000000000000000000
00000000000000000000000000000000000000000000000000000000000000000000000000000000
00000000000000000000000000000000000000000000000000000000000000000000000000000000
00000000000000000000000000000000000000000000000000000000000000000000000000000000
00000000000000000000000000000000000000000000000000000000000000000000000000000000
00000000000000000000000000000000000000000000000000000000000000000000000000000000
00000000000000000000000000000000000000000000000000000000000000000000000000000000
00000000000000000000000000000000000000000000000000000000000000000000000000000000
00000000000000000000000000000000000000000000000000000000000000000000000000000000
00000000000000000000000000000000000000000000000000000000000000000000000000000000
00000000000000000000000000000000000000000000000000000000000000000000000000000000
00000000000000000000000000000000000000000000000000000000000000000000000000000000
00000000000000000000000000000000000000000000000000000000000000000000000000000000
00000000000000000000000000000000000000000000000000000000000000000000000000000000
00000000000000000000000000000000000000000000000000000000000000000000000000000000
00000000000000000000000000000000000000000000000000000000000000000000000000000000
00000000000000000000000000000000000000000000000000000000000000000000000000000000
00000000000000000000000000000000000000000000000000000000000000000000000000000000
00000000000000000000000000000000000000000000000000000000000000000000000000000000
00000000000000000000000000000000000000000000000000000000000000000000000000000000
00000000000000000000000000000000000000000000000000000000000000000000000000000000
00000000000000000000000000000000000000000000000000000000000000000000000000000000
00000000000000000000000000000000000000000000000000000000000000000000000000000000
00000000000000000000000000000000000000000000000000000000000000000000000000000000
00000000000000000000000000000000000000000000000000000000000000000000000000000000
00000000000000000000000000000000000000000000000000000000000000000000000000000000
00000000000000000000000000000000000000000000000000000000000000000000000000000000
00000000000000000000000000000000000000000000000000000000000000000000000000000000
00000000000000000000000000000000000000000000000000000000000000000000000000000000
00000000000000000000000000000000000000000000000000000000000000000000000000000000
00000000000000000000000000000000000000000000000000000000000000000000000000000000
00000000000000000000000000000000000000000000000000000000000000000000000000000000
00000100000000000000000000000000000000000000000000000000000000000000000000000000
00000100011100000000000000000000000000000000000000000000000000000000000000000000
00001100111000000000000000000000000000000000000000000000000000000000000000000000
01001100100000000000000000000000000000000000000000000000000000000000000000000000
01111001100000000000000000000000000000000000000000000000000000000000000000000000
00011011111000000000000000000000000000000000000000000000000000000000000000000000
00011110011100011100000000000000000000000000000000000000000000000000000000000000
00000000001100111100000000000000000000000000000000000000000000000000000000000000
00000000011111111000000000000000000000000000000000000000000000000000000000000000
00011111111100111000000000000000000000000000000000000000000000000000000000000000
00011110001100011000000000000000000000000000000000000000000000000000000000000000
00111110011100010000000000000000000000000000000000000000000000000000000000000000
01111111111000110000000000000000000000000000000000000000000000000000000000000000
01100000011100110000000000000001000000000000000000000000000000000000000000000000
01100000011110110000001000000011000000000000000000000000000000000000000000000000
01000000011110110000001111000010000000000000000000000000000000000000000000000000
01000000011111111001111111100010000000000000000000000000000000000000000000000000
00000001011101111001011111100010000000000000000000000000000000000000000000000000
00000001100000110010000111000110000000000000000000000000000000000000000000000000
00000001100000010011000111001100001100000000000000000000000000000000000000000000
00000111111000011001100111111000000100000000000000000000000000000000000000000000
01001111111100111000110111111111100100000000000000000000000000000000000000000000
01111111101110111000111101111100111100000000000000000000000000000000000000000000
00111111000011111000111000011101110000000000000000000000000000000000000000000000
00010100000001111111110000011111100000000000000000000000000000000000000000000000
00001100111000111001110001110111111000000000000000000000000000000000000000000000
00001111111110111001110011100112111110000000000000000000000000000000000000000000
00000011101111111001110111000011100011000000000000000000000000000000000000000000
00000000000011111111100110000000000000000000000000000000000000000000000000000000
00000000000011000110000111100000000000000000000000000000000000000000000000000000
00000000000000000000000000000000000000000000000000000000000000000000000000000000
