80 80
00000000000000000000000000000000000000000000000000000000000000000000000000000000
00000000000000000000000000000000000000000000000000000000000000000000000000000000
00000000000000000000000000000000000000000000000000000000000000000000000000000000
00000000000000000000000000000000000000000000000000000000000000000000000000000000
00000000000000000000000000000000000000000000000000000000000000000000000000000000
00000000000000000000000000000000000000000000000000000000000000000000000000000000
00000000000000000000000000000000000000000000000000000000000000000000000000000000
00000000000000000000000000000000000000000000000000000000000000000000000000000000
00000000000000000000000000000000000000000000000000000000000000000000000000000000
00000000000000000000000000000000000000000000000000000000000000000000000000000000
00000000000000000000000000000000000000000000000000000000000000000000000000000000
00000000000000000000000000000000000000000000000000000000000000000000000000000000
00000000000000000000000000000000000000000000000000000000000000000000000000000000
00000000000000000000000000000000000000000000000000000000000000000000000000000000
00000000000000000000000000000000000000000000000000000000000000000000000000000000
00000000000000000000000000000000000000000000000000000000000000000000000000000000
00000000000000000000000000000000000000000000000000000000000000000000000000000000
00000000000000000000000000000000000000000000000000000000000000000000000000000000
00000000000000000000000000000000000000000000000000000000000000000000000000000000
00000000000000000000000000000000000000000000000000000000000000000000000000000000
00000000000000000000000000000000000000000000000000000000000000000000000000000000
00000000000000000000000000000000000000000000000000000000000000000000000000000000
00000000000000000000000000000000000000000000000000000000000000000000000000000000
00000000000000000000000000000000000000000000000000000000000000000000000000000000
00000000000000000000000000000000000000000000000000000000000000000000000000000000
00000000000000000000000000000000000000000000000000000000000000000000000000000000
00000000000000000000000000000000000000000000000000000000000000000000000000000000
00000000000000000000000000000000000000000000000000000000000000000000000000000000
00000000000000000000000000000000000000000000000000000000000000000000000000000000
00000000000000000000000000000000000000000000000000000000000000000000000000000000
00000000000000000000000000000000000000000000000000000000000000000000000000000000
00000000000000000000000000000000000000000000000000000000000000000000000000000000
00000000000000000000000000000000000000000000000000000000000000000000000000000000
00000000000000000100000000000000000000000000000000000000000000000000000000000000
00000000000000001111000000000000000000000000000000000000000000000000000000000000
00000000000000111011111000000000000000000000000000000000000000000000000000000000
00000000000000110001111000000000000000000000000000000000000000000000000000000000
00000000000000110011111000000000000000000000000000000000000000000000000000000000
00000000000000111111101000000000000000000000000000000000000000000000000000000000
00000000000100011111101000000000000000000000000000000000000000000000000000000000
00000000011111111111111111000000000000000000000000000000000000000000000000000000
00000000011011110010101101000000000000000000000000000000000000000000000000000000
00000000011000000000000100000000000000000000000000000000000000000000000000000000
00000000011000000000000111000000000000000000000000000000000000000000000000000000
00000000001101100001101111000000000000000000000000000000000000000000000000000000
00000000011111111111111111100000001100000000000000000000000000000000000000000000
00000000001001011111111111100100011000000000000000000000000000000000000000000000
00000000000000001111111001111100011000000000000000000000000000000000000000000000
00000000000000001111111000000011111000000010000000000000000000000000000000000000
00000000000000011000111001111111001110000110000000000000000000000000000000000000
00000000001110110001111111111110001110011100000000000000000000000000000000000000
00000000001111110001000011111111001111111000000000000000000000000000000000000000
00000001001001100000000010011111000001110000000000000000000000000000000000000000
00000001111000000011000001001111000000111000000000000000000000000000000000000000
00000001011000100001100001100111110001111100000000000000000000000000000000000000
00000000001111111001110001000111111111111100000000000000000000000000000000000000
00000000001111001001110011000111100000011000000000000000000000000000000000000000
00000000000000001011111110001111000000001100000000000000000000000000000000000000
00000000000000001111100000001111000000001110000000000000000000000000000000000000
00000000000000010111100011111011110000001111100010000000000000000000000000000000
00000000011111111111110111111111111110001111111111100000000000000000000000000000
00000000000011111111110111121110000000011001010000000000000000000000000000000000
00000000000001110111110111111100000000011001100000000000000000000000000000000000
00000000000001100011110011111110000000001000100000000000000000000000000000000000
00000000010001110111110011011111111100001000000000000000000000000000000000000000
00000000011111111111110011111111111100001000000000000000000000000000000000000000
00000000000110011111100000111111100110001000000000000000000000000000000000000000
00000000000000001111000000000011100011011100000000000000000000000000000000000000
00000000000001111110000011100000000001110000000000000000000000000000000000000000
00000000011001111111100011100000000000110000000000000000000000000000000000000000
00000000001111111111111111100000000000000000000000000000000000000000000000000000
00000000001111110010111110000000000000000000000000000000000000000000000000000000
00000000000110000011110000000000000000000000000000000000000000000000000000000000
00000000111010000111000000000000000000000000000000000000000000000000000000000000
00000000001011011111100000000000000000000000000000000000000000000000000000000000
00000000001011111111110000000000000000000000000000000000000000000000000000000000
00000000001111110010100000000000000000000000000000000000000000000000000000000000
00000000000101110000100000000000000000000000000000000000000000000000000000000000
00000000000000010000110000000000000000000000000000000000000000000000000000000000
00000000000000000000000000000000000000000000000000000000000000000000000000000000
