80 80
00000000000000000000000000000000000000000000000000000000000000000000000000000000
00000111111111111111100000000010000000000000000000000000000000000000000000000000
00000011111100111111110000000011010000000000000000000000000000000000000000000000
00000000111111001011110111000011111000000000000000000000000000000000000000000000
00000000111111111111110011100111001100000000000000000000000000000000000000000000
00001111111111111111110011100111000100000000000000000000000000000000000000000000
00000001111111111111110011100111000100000000000000000000000000000000000000000000
00000000111110000001111111000011000000000000000000000000000000000000000000000000
00010000111110000001111111100011100000000000000000000000000000000000000000000000
00011100111111000011111211110011000000000000000000000000000000000000000000000000
00001111111111111111111111111111000000000000000000000000000000000000000000000000
00000111111111111111111111111110000000000000000000000000000000000000000000000000
00000000111111100111111100111000000000000000000000000000000000000000000000000000
00000000111001111111011100010000000000000000000000000000000000000000000000000000
00000100011000111111111011111110000110000000000000000000000000000000000000000000
01111110011100111111111011111111101110000000000000000000000000000000000000000000
01111111001111111101111110011111111100000000000000000000000000000000000000000000
00000001001111001111111100000111110000000000000000000000000000000000000000000000
00000001101111001110110000000011000000000000000000000000000000000000000000000000
00000111111111111000110000000011000000000000000000000000000000000000000000000000
01111111111111111001100000000010000000000000000000000000000000000000000000000000
01111110111110011001100000000110000000000000000000000000000000000000000000000000
01110111111100001100000000000100000000000000000000000000000000000000000000000000
00111100110000000000000000000000000000000000000000000000000000000000000000000000
00001100010000110000000000000000000000000000000000000000000000000000000000000000
00000100011111111000000000000000000000000000000000000000000000000000000000000000
00000110000110011111000000000000000000000000000000000000000000000000000000000000
00000000000000000110000000000000000000000000000000000000000000000000000000000000
00000000000000000000000000000000000000000000000000000000000000000000000000000000
00000000000000000000000000000000000000000000000000000000000000000000000000000000
00000000000000000000000000000000000000000000000000000000000000000000000000000000
00000000000000000000000000000000000000000000000000000000000000000000000000000000
00000000000000000000000000000000000000000000000000000000000000000000000000000000
00000000000000000000000000000000000000000000000000000000000000000000000000000000
00000000000000000000000000000000000000000000000000000000000000000000000000000000
00000000000000000000000000000000000000000000000000000000000000000000000000000000
00000000000000000000000000000000000000000000000000000000000000000000000000000000
00000000000000000000000000000000000000000000000000000000000000000000000000000000
00000000000000000000000000000000000000000000000000000000000000000000000000000000
00000000000000000000000000000000000000000000000000000000000000000000000000000000
00000000000000000000000000000000000000000000000000000000000000000000000000000000
00000000000000000000000000000000000000000000000000000000000000000000000000000000
00000000000000000000000000000000000000000000000000000000000000000000000000000000
00000000000000000000000000000000000000000000000000000000000000000000000000000000
00000000000000000000000000000000000000000000000000000000000000000000000000000000
00000000000000000000000000000000000000000000000000000000000000000000000000000000
00000000000000000000000000000000000000000000000000000000000000000000000000000000
00000000000000000000000000000000000000000000000000000000000000000000000000000000
00000000000000000000000000000000000000000000000000000000000000000000000000000000
00000000000000000000000000000000000000000000000000000000000000000000000000000000
00000000000000000000000000000000000000000000000000000000000000000000000000000000
00000000000000000000000000000000000000000000000000000000000000000000000000000000
00000000000000000000000000000000000000000000000000000000000000000000000000000000
00000000000000000000000000000000000000000000000000000000000000000000000000000000
00000000000000000000000000000000000000000000000000000000000000000000000000000000
00000000000000000000000000000000000000000000000000000000000000000000000000000000
00000000000000000000000000000000000000000000000000000000000000000000000000000000
00000000000000000000000000000000000000000000000000000000000000000000000000000000
00000000000000000000000000000000000000000000000000000000000000000000000000000000
00000000000000000000000000000000000000000000000000000000000000000000000000000000
00000000000000000000000000000000000000000000000000000000000000000000000000000000
00000000000000000000000000000000000000000000000000000000000000000000000000000000
00000000000000000000000000000000000000000000000000000000000000000000000000000000
00000000000000000000000000000000000000000000000000000000000000000000000000000000
00000000000000000000000000000000000000000000000000000000000000000000000000000000
00000000000000000000000000000000000000000000000000000000000000000000000000000000
00000000000000000000000000000000000000000000000000000000000000000000000000000000
00000000000000000000000000000000000000000000000000000000000000000000000000000000
00000000000000000000000000000000000000000000000000000000000000000000000000000000
00000000000000000000000000000000000000000000000000000000000000000000000000000000
00000000000000000000000000000000000000000000000000000000000000000000000000000000
00000000000000000000000000000000000000000000000000000000000000000000000000000000
00000000000000000000000000000000000000000000000000000000000000000000000000000000
00000000000000000000000000000000000000000000000000000000000000000000000000000000
00000000000000000000000000000000000000000000000000000000000000000000000000000000
00000000000000000000000000000000000000000000000000000000000000000000000000000000
00000000000000000000000000000000000000000000000000000000000000000000000000000000
00000000000000000000000000000000000000000000000000000000000000000000000000000000
00000000000000000000000000000000000000000000000000000000000000000000000000000000
00000000000000000000000000000000000000000000000000000000000000000000000000000000
