80 80
00000000000000000000000000000000000000000000000000000000000000000000000000000000
00000000000000000000000000000000000000000000000000000000000000000000000000000000
00000000000000000000000000000000000000000000000000000000000000000000000000000000
00000000000000000000000000000000000000000000000000000000000000000000000000000000
00000000000000000000000000000000000000000000000000000000000000000000000000000000
00000000000000000000000000000000000000000000000000000000000000000000000000000000
00000000000000000000000000000000000000000000000000000000000000000000000000000000
00000000000000000000000000000000000000000000000000000000000000000000000000000000
00000000000000000000000000000000000000000000000000000000000000000000000000000000
00000000000000000000000000000000000000000000000000000000000000000000000000000000
00000000000000000000000000000000000000000000000000000000000000000000000000000000
00000000000000000000000000000000000000000000000000000000000000000000000000000000
00000000000000000000000000000000000000000000000000000000000000000000000000000000
00000000000000000000000000000000000000000000000000000000000000000000000000000000
00000000000000000000000000000000000000000000000000000000000000000000000000000000
00000000000000000000000000000000000000000000000000000000000000000000000000000000
00000000000000000000000000000000000000000000000000000000000000000000000000000000
00000000000000000000000000000000000000000000000000000000000000000000000000000000
00000000000000000000000000000000000000000000000000000000000000000000000000000000
00000000000000000000000000000000000000000000000000000000000000000000000000000000
00000000000000000000000000000000000000000000000000000000000000000000000000000000
00000000000000000000000000000000000000000000000000000000000000000000000000000000
00000000000000000000000000000000000000000000000000000000000000000000000000000000
00000000000000000000000000000000000000000000000000000000000000000000000000000000
00000000000000000000000000000000000000000000000000000000000000000000000000000000
00000000000000000000000000000000000000000000000000000000000000000000000000000000
00000000000000000000000000000000000000000000000000000000000000000000000000000000
00000000000000000000000000000000000000000000000000000000000000000000000000000000
00000000000000000000000000000000000000000000000000000000000000000000000000000000
00000000000000000000000000000000000000000000000000000000000000000000000000000000
00000000000000000000000000000000000000000000000000000000000000000000000000000000
00000000000000000000000000000000000000000000000000000000000000000000000000000000
00000000000000000000000000000000000000000000000000000000000000000000000000000000
00000000000000000000000000000000000000000000000000000000000000000000000000000000
00000000000000000000000000000000000000000000000000000000000000000000000000000000
00000000000000000000100000000000000000000000000000000000000000000000000000000000
00000000000000000000100000000000000000000000000000000000000000000000000000000000
00000000000000000000100000000000000000000000000000000000000000000000000000000000
00000000000000000000100000000000000000000000000000000000000000000000000000000000
00000000000000000001100000000000000000000000000000000000000000000000000000000000
00000000000000000000100000000000000000000000000000000000000000000000000000000000
00000000000000000000100000000000000000000000000000000000000000000000000000000000
00000000000000000001111000000000000000000000000000000000000000000000000000000000
00000000000000000011100000000000000000000000000000000000000000000000000000000000
00000000000000100001100000000000000000000000000000000000000000000000000000000000
00000000011111111111100000000000000000000000000000000000000000000000000000000000
00000000000100001100110000000000000000000000000000000000000000000000000000000000
00000000000000000000011000000000000000000000000000000000000000000000000000000000
00000000000000000111111000000000000000000000000000000000000000000000000000000000
00000000111000011101111100000000000000000000000000000000000000000000000000000000
00000000111100111011111111100000000000000000000000000000000000000000000000000000
00000000101111111111111000110000000000000000000000000000000000000000000000000000
00010000000111111110000001111100000000000000000000000000000000000000000000000000
00010000000011111110000011000000000000000000000000000000000000000000000000000000
00011101111111111110110111000000000000000000000000000000000000000000000000000000
01001111111111111111111111100000000000000000000000000000000000000000000000000000
01100111111111111111101101100000000000000000000000000000000000000000000000000000
00110011111111111111001101100000000000000000000000000000000000000000000000000000
00111101111111111111111111100000000000000000000000000000000000000000000000000000
01111111111111111001111111000000000000000000000000000000000000000000000000000000
01111111111111111001111111100000000000000000000000000000000000000000000000000000
01111111121111111111111101111000000000000000000000000000000000000000000000000000
01111111111111111111111000011000000000000000000000000000000000000000000000000000
01111111111111111111111000011000000000000000000000000000000000000000000000000000
01101111111111111011111111011010000000000000000000000000000000000000000000000000
01101111111111111001111111100110000000000000000000000000000000000000000000000000
01111111111111111101111111100010000000000000000000000000000000000000000000000000
01101100111111111100011111111110000000000000000000000000000000000000000000000000
01000100011011111110001111101111000000000000000000000000000000000000000000000000
01001100001111111111111111001111100000000000000000000000000000000000000000000000
01001110011111111111111111111111000000000000000000000000000000000000000000000000
00000111111111111011111100111110000000000000000000000000000000000000000000000000
00000011111110111111111000001100000000000000000000000000000000000000000000000000
01100000001100111111111000000100000000000000000000000000000000000000000000000000
01111100011100110011111100000110000000000000000000000000000000000000000000000000
01101100001000011011111111100010000000000000000000000000000000000000000000000000
00000110001100011001110000100011000000000000000000000000000000000000000000000000
00000011011100011000110000000001000000000000000000000000000000000000000000000000
00000011111101110000111000000001000000000000000000000000000000000000000000000000
00000000000000000000000000000000000000000000000000000000000000000000000000000000
