80 80
00000000000000000000000000000000000000000000000000000000000000000000000000000000
00000000000000000000000000000000000000000000000000000000000000000000000000000000
00000000000000000000000000000000000000000000000000000000000000000000000000000000
00000000000000000000000000000000000000000000000000000000000000000000000000000000
00000000000000000000000000000000000000000000000000000000000000000000000000000000
00000000000000000000000000000000000000000000000000000000000000000000000000000000
00000000000000000000000000000000000000000000000000000000000000000000000000000000
00000000000000000000000000000000000000000000000000000000000000000000000000000000
00000000000000000000000000000000000000000000000000000000000000000000000000000000
00000000000000000000000000000000000000000000000000000000000000000000000000000000
00000000000000000000000000000000000000000000000000000000000000000000000000000000
00000000000000000000000000000000000000000000000000000000000000000000000000000000
00000000000000000000000000000000000000000000000000000000000000000000000000000000
00000000000000000000000000000000000000000000000000000000000000000000000000000000
00000000000000000000000000000000000000000000000000000000000000000000000000000000
00000000000000000000000000000000000000000000000000000000000000000000000000000000
00000000000000000000000000000000000000000000000000000000000000000000000000000000
00000000000000000000000000000000000000000000000000000000000000000000000000000000
00000000000000000000000000000000000000000000000000000000000000000000000000000000
00000000000000000000000000000000000000000000000000000000000000000000000000000000
00000000000000000000000000000000000000000000000000000000000000000000000000000000
00000000000000000000000000000000000000000000000000000000000000000000000000000000
00000000000000000000000000000000000000000000000000000000000000000000000000000000
00000000000000000000000000000000000000000000000000000000000000000000000000000000
00000000000000000000000000000000000000000000000000000000000000000000000000000000
00000000000000000000000000000000000000000000000000000000000000000000000000000000
00000000000000000000000000000000000000000000000000000000000000000000000000000000
00000000000000000000000000000000000000000000000000000000000000000000000000000000
00000000000000000000000000000000000000000000000000000000000000000000000000000000
00000000000000000000000000000000000000000000000000000000000000000000000000000000
00000000000000000000000000000000000000000000000000000000000000000000000000000000
00000000000000000000000000000000000000000000000000000000000000000000000000000000
00000000000000000000000000000000000000000000000000000000000000000000000000000000
00000000000000000000000000000000000000000000000000000000000000000000000000000000
00000000000000000000000000000000000000000000000000000000000000000000000000000000
00000000000000000000000000000000000000000000000000000000000000000000000000000000
00000000000000000000000000000000000000000000000000000000000000000000000000000000
00000000000000000000000000000000000000000000000000000000000000000000000000000000
00000000000000000000000000000000000000000000000000000000000000000000000000000000
00000000000000000000000000000000000000000000000000000000000000000000000000000000
00000000000000000000000000000000000000000000000000000000000000000000000000000000
00000000000000000000000000000000000000000000000000000000000000000000000000000000
00000000000000000000000000000000000000000000000000000000000000000000000000000000
00000000000000000000000000000000000000000000000000000000000000000000000000000000
00000000001000011110001111000000000000000000000000000000000000000000000000000000
00000000001000010011111111100000000000000000000000000000000000000000000000000000
00000000001000010000000111100000000000000000000000000000000000000000000000000000
00000000001100110000000111111000000000000000000000000000000000000000000000000000
00000000011100000111111111100000000000000000000000000000000000000000000000000000
00000000011000011111101101000000000000000000000000000000000000000000000000000000
00001111011000010111111101000000000000000000000000000000000000000000000000000000
00000001111100110110111111000000000000000000000000000000000000000000000000000000
01000001101111100010011110000000000000000000000000000000000000000000000000000000
01111110000000000010011100000000000000000000000000000000000000000000000000000000
01111110001000111000111001000000000000000000000000000000000000000000000000000000
01111110001000111101111111000000000000000000000000000000000000000000000000000000
00111111001100111111101101000000000000000000000000000000000000000000000000000000
00010000000110100100000100000000000000000000000000000000000000000000000000000000
00011000000011100000001100000001100000000000000000000000000000000000000000000000
01011100011111110000111110000011111100000000000000000000000000000000000000000000
01001111111111111001111111100011111111000000000000000000000000000000000000000000
01000111001111111011111101100110110111000000000000000000000000000000000000000000
01100000000111111111100111111110010011110000000000000000000000000000000000000000
01110000001111111111100001111000000011000000000000000000000000000000000000000000
01011100011111111111110001111011000111001000000000000000000000000000000000000000
01011110011111111111110011111111111111001000000000000000000000000000000000000000
01001111111111111111111111001110111101111000000000000000000000000000000000000000
01100111111111112111111100001110111000110000000000000000000000000000000000000000
01111111111111111111111000011110011100000000000000000000000000000000000000000000
01111111111111111111111001111110011111000000000000000000000000000000000000000000
01111111111111111111111011100111111110000000000000000000000000000000000000000000
01100111111111111111110011000011111100000000000000000000000000000000000000000000
01100000001111111111110111000111110000000000000000000000000000000000000000000000
01110000001111111111111111101111111001100000000000000000000000000000000000000000
01011100111111111111111111111111111111000000000000000000000000000000000000000000
01011111111111111111111111111111111111000000000000000000000000000000000000000000
01000111111111111111111111111111100111000000000000000000000000000000000000000000
01000001111101111111111111111111000000000000000000000000000000000000000000000000
01100111111100110001100111011111100000000000000000000000000000000000000000000000
00000000000000000000000000000000000000000000000000000000000000000000000000000000
