80 80
00000000000000000000000000000000000000000000000000000000000000000000000000000000
00000000000000000000000000000000000000000000000000000000000000000000000000000000
00000000000000000000000000000000000000000000000000000000000000000000000000000000
00000000000000000000000000000000000000000000000000000000000000000000000000000000
00000000000000000000000000000000000000000000000000000000000000000000000000000000
00000000000000000000000000000000000000000000000000000000000000000000000000000000
00000000000000000000000000000000000000000000000000000000000000000000000000000000
00000000000000000000000000000000000000000000000000000000000000000000000000000000
00000000000000000000000000000000000000000000000000000000000000000000000000000000
00000000000000010000011000000000000000000000000000000000000000000000000000000000
00000000000000111001111111111110000000000000000000000000000000000000000000000000
00000000000000111011100011111111000000000000000000000000000000000000000000000000
00000000000000011111000011111100000000000000000000000000000000000000000000000000
00000000000000011111111111111111111000000000000000000000000000000000000000000000
00000000000000011001111111111111111100000000000000000000000000000000000000000000
00000000000000011001111111121111111110000000000000000000000000000000000000000000
00000000000000000001111111111111111110000000000000000000000000000000000000000000
00000000000000000000111111111110000011100000000000000000000000000000000000000000
00000000000000000000111111111110001111100000000000000000000000000000000000000000
00000000000000110000110111111111111110000000000000000000000000000000000000000000
00000000000000111000110011111111111110000000000000000000000000000000000000000000
00000000000000111001100001111111101110000000000000000000000000000000000000000000
00000000000000111111000001100000000000000000000000000000000000000000000000000000
00000000000000010000000111000000100000000000000000000000000000000000000000000000
00000000000000010000000011100001111100111000000000000000000000000000000000000000
00000000000000011000000001000111111111111000000000000000000000000000000000000000
00000000000000000000000001000110001111011100000000000000000000000000000000000000
00000000000000000000000001100100001111100000000000000000000000000000000000000000
00000000000000000000000001111111110111000000000000000000000000000000000000000000
00000000000000000000000001111111110011000000000000000000000000000000000000000000
00000000000000000000000001111111111111000000000000000000000000000000000000000000
00000000000000000000000001011011100001100000000000000000000000000000000000000000
00000000000000000000000011011000000000000000001100000000000000000000000000000000
00000000000000000000000001111000000000000000011111000000000000000000000000000000
00000000000000000000000001111100110000000000011011000000000000000000000000000000
00000000000000000000000001100111111100000000011011111000000000000000000000000000
00000000000000000000000001100011100100000000011000000000000000000000000000000000
00000000000000000000000000110011111000000000001100000000000000000000000000000000
00000000000000000000000000001111001100000000001100000000000000000000000000000000
00000000000000000000000000000110000100011110011111100000000000000000000000000000
00000000000000000000000000000111000100011111111111111000000000000000000000000000
00000000000000000000000000000010000100011111100011110000000000000000000000000000
00000000000000000000000000000000001100111000000011100000000000000000000000000000
00000000000000000000000000000000001100011000000001100000000000000000000000000000
00000000000000000000000000000010001100011111110111100000000000000000000000000000
00000000000000000000000001000011101110111111111111110000000000000000000000000000
00000000000000000000000001000111111111111111111111110000000000000000000000000000
00000000000000000000000001100111111111111111111100000000000000000000000000000000
00000000000000000000000001000111111111111111111000000000000000000000000000000000
00000000000000000000000001000111111111111111111001111101000000000000000000000000
00000000000000000000000011100111111111111111111111111111100000000000000000000000
00000000000000000000000001100111111111111110011111110000000000000000000000000000
00000000000000000000000111100111111111111000001111111000000000000000000000000000
00000000000000000000000001111111111111100000001111100000000000000000000000000000
00000000000000000000000001111111111111110000001111100000000000000000000000000000
00000000000000000000000001111111111111111100111100100000000000000000000000000000
00000000000000000000000011011111111111000000000000000000000000000000000000000000
00000000000000000000000111001001110011000000000000000000000000000000000000000000
00000000000000000000000111001100010001100000000000000000000000000000000000000000
00000000000000000000000011101110011000000000000000000000000000000000000000000000
00000000000000000000100011100111011110000000000000000000000000000000000000000000
00000000000000000000110011100011100000000000000000000000000000000000000000000000
00000000000000000000111011110001100000000000000000000000000000000000000000000000
00000000000000000000011111011001110000000000000000000000000000000000000000000000
00000000000000000001111111001111100000000000000000000000000000000000000000000000
00000000000000000001111111111111111100000000000000000000000000000000000000000000
00000000000000000000001001111111101100000000000000000000000000000000000000000000
00000000000000000000000111110011101100000000000000000000000000000000000000000000
00000000000000000000000011110011001110000000000000000000000000000000000000000000
00000000000000000000000001110010001110001000000000000000000000000000000000000000
00000000000000000000000001011010001110001000000000000000000000000000000000000000
00000000000000000000000001011111001110001000000000000000000000000000000000000000
00000000000000000000000000111111111111011000000000000000000000000000000000000000
00000000000000000000000000001111111111110000000000000000000000000000000000000000
00000000000000000000000000011111111111111000000000000000000000000000000000000000
00000000000000000000000111111111111111011100000000000000000000000000000000000000
00000000000000000000000000110111111111000000000000000000000000000000000000000000
00000000000000000000000000000011111011100000000000000000000000000000000000000000
00000000000000000000000000000011111001100000000000000000000000000000000000000000
00000000000000000000000000000000000000000000000000000000000000000000000000000000
