80 80
00000000000000000000000000000000000000000000000000000000000000000000000000000000
00000000000000000000000000000000000000000000000000000000000000000000000000000000
00000000000000000000000000000000000000000000000000000000000000000000000000000000
00000000000000000000000000000000000000000000000000000000000000000000000000000000
00000000000000000000000000000000000000000000000000000000000000000000000000000000
00000000000000000000000000000000000000000000000000000000000000000000000000000000
00000000000000000000000000000000000000000000000000000000000000000000000000000000
00000000000000000000000000000000000000000000000000000000000000000000000000000000
00000000000000000000000000000000000000000000000000000000000000000000000000000000
00000000000000000000000000000000000000000000000000000000000000000000000000000000
00000000000000000000000000000000000100000000000000000000000000000000000000000000
00000000000000000000000000000000111100000000000000000000000000000000000000000000
00000000000000000000000000000000001100000000000000000000000000000000000000000000
00000000000000000000100000000000000100000000000000000000000000000000000000000000
00000000000000000000100000000000000100000000000000000000000000000000000000000000
00000000000000000000100001000000000100000001111000000000000000000000000000000000
00000000000000000001100001000000000100000001001000000000000000000000000000000000
00000000000000000001110011000000011100000011000000000000000000000000000000000000
00000000000000000000110010001111111100000001011000001000000000000000000000000000
00000000000000000000110011011111111110011001111110111000000000000000000000000000
00000000000000000001111111111111211110111101111111110000000000000000000000000000
00000000000000000001111111111111111111111111111111100000000000000000000000000000
00000000000000000001111111111111111111111111111111000000000000000000000000000000
00000000000000000000111111100011111111111100011001100000000000000000000000000000
00000000000000001111111011000011111111111100011001100000000000000000000000000000
00000000000000111111111011000111111111011100010000110000000000000000000000000000
00000000000000110001110011000111111110011100110000110000000000000000000000000000
00000000000001100000000111001111100001111000110000000000000000000000000000000000
00000000000111100000001110011111000011111000100100000000000000000000000000000000
00000000001111110001111111111110000110011000111111000000000000000000000000000000
00000000011111111011111111100111000100001101111111110000000000000000000000000000
00000000111011111111110111000011001100001111111100111000000000000000000000000000
00000000111111111111110110000011001100000011111111110000000000000000000000000000
00000000010001111111111111100100000000000011000001100000000000000000000000000000
00000000011001111001111111111110000000000010000000100000000000000000000000000000
00000000011111111101110111111111000000000000000000100000000000000000000000000000
00000000001111111111110011110000000000000000000000100000000000000000000000000000
00000000000111111111100001100000000000000000000000000000000000000000000000000000
00000000001111111111000000100000000000000000000000000000000000000000000000000000
00000000011011111001100001100000000000000000000000000000000000000000000000000000
00000000011111111011110011100000000000000000000000000000000000000000000000000000
00000000001110011111111111000000000000000000000000000000000000000000000000000000
00000000000100000110001110001000000000000000000000000000000000000000000000000000
00000000000110000111000110001000000000000000000000000000000000000000000000000000
00000001111111100110110011001110000000000000000000000000000000000000000000000000
00000000111111111111110011111111000000000000000000000000000000000000000000000000
00000000111100011101100000111111000000000000000000000000000000000000000000000000
00000000001100000000000000000000000000000000000000000000000000000000000000000000
00000000000110000000000000000000000000000000000000000000000000000000000000000000
00000000000100000000000000000000000000000000000000000000000000000000000000000000
00000110011100000000000000000000000000000000000000000000000000000000000000000000
00000011111000000000000000000000000000000000000000000000000000000000000000000000
00000000111000000000000000000000000000000000000000000000000000000000000000000000
00000000110000000000000000000000000000000000000000000000000000000000000000000000
00000000000000000000000000000000000000000000000000000000000000000000000000000000
00000000000000000000000000000000000000000000000000000000000000000000000000000000
00000000000000000000000000000000000000000000000000000000000000000000000000000000
00000000000000000000000000000000000000000000000000000000000000000000000000000000
00000000000000000000000000000000000000000000000000000000000000000000000000000000
00000000000000000000000000000000000000000000000000000000000000000000000000000000
00000000000000000000000000000000000000000000000000000000000000000000000000000000
00000000000000000000000000000000000000000000000000000000000000000000000000000000
00000000000000000000000000000000000000000000000000000000000000000000000000000000
00000000000000000000000000000000000000000000000000000000000000000000000000000000
00000000000000000000000000000000000000000000000000000000000000000000000000000000
00000000000000000000000000000000000000000000000000000000000000000000000000000000
00000000000000000000000000000000000000000000000000000000000000000000000000000000
00000000000000000000000000000000000000000000000000000000000000000000000000000000
00000000000000000000000000000000000000000000000000000000000000000000000000000000
00000000000000000000000000000000000000000000000000000000000000000000000000000000
00000000000000000000000000000000000000000000000000000000000000000000000000000000
00000000000000000000000000000000000000000000000000000000000000000000000000000000
00000000000000000000000000000000000000000000000000000000000000000000000000000000
00000000000000000000000000000000000000000000000000000000000000000000000000000000
00000000000000000000000000000000000000000000000000000000000000000000000000000000
00000000000000000000000000000000000000000000000000000000000000000000000000000000
00000000000000000000000000000000000000000000000000000000000000000000000000000000
00000000000000000000000000000000000000000000000000000000000000000000000000000000
00000000000000000000000000000000000000000000000000000000000000000000000000000000
00000000000000000000000000000000000000000000000000000000000000000000000000000000
