80 80
00000000000000000000000000000000000000000000000000000000000000000000000000000000
00000000000000000000000000000000000000000000000000000000000000000000000000000000
00000000000000000000000000000000000000000000000000000000000000000000000000000000
00000000000000000000000000000000000000000000000000000000000000000000000000000000
00000000000000000000000000000000000000000000000000000000000000000000000000000000
00000000000000000000000000000000000000000000000000000000000000000000000000000000
00000000000000000000000000000000000000000000000000000000000000000000000000000000
00000000000000000000000000000000000000000000000000000000000000000000000000000000
00000000000000000000000000000000000000000000000000000000000000000000000000000000
00000000000000000000000000000000000000000000000000000000000000000000000000000000
00000000000000000000000000000000000000000000000000000000000000000000000000000000
00000000000000000000000000000000000000000000000000000000000000000000000000000000
00000000000000000000000000000000000000000000000000000000000000000000000000000000
00000000000000000000000000000000000000000000000000000000000000000000000000000000
00000000000000000000000000000000000000000000000000000000000000000000000000000000
00000000000000000000000000000000000000000000000000000000000000000000000000000000
00000000000000000000000000000000000000000000000000000000000000000000000000000000
00000000000000000000000000000000000000000000000000000000000000000000000000000000
00000000000000000000000000000000000000000000000000000000000000000000000000000000
00000000000000000000000000000000000000000000000000000000000000000000000000000000
00000000000000000000000000000000000000000000000000000000000000000100000000000000
00000000000000000000000000000000000000000000000000000000000000001100000100000000
00000000000000000000000000000000000000000000000000000000000001001111000110000000
00000000000000000000000000000000000000000000000000000000000011111111111111000000
00000000000000000000000000000000000000000000000000000000000011011101111100000000
00000000000000000000000000000000000000000000000000100000000011001111111100000000
00000000000000000000000000000000000000000000000000110000000110000111111100000000
00000000000000000000000000000000000000000000000000100000000111000000111100000000
00000000000000000000000000000000000000000000000111100000000011000000011100000000
00000000000000000000000000000000000000000000000101000000110011111100001110011000
00000000000000000000000000000000000000000000000001111111100111111111111100111110
00000000000000000000000000000000000000000000000000011111000110111111111000111010
00000000000000000000000000000000000000000000000000001110000010110111111000111110
00000000000000000000000000000000000000000000000000001111000010110111111111111110
00000000000000000000000000000000000000000000000000111111000111111111111112111110
00000000000000000000000000000000000000000000000000111111000111111110111111111110
00000000000000000000000000000000000000000000000001111111000111111110111111111110
00000000000000000000000000000000000000000000000001111111000110111100111111000010
00000000000000000000000000000000000000000000000001110111001001111100011011100000
00000000000000000000000000000000000000000000000001100011111111111110011100111000
00000000000000000000000000000000000000000000000000100011111111111110011100111000
00000000000000000000000000000000000000000000000000110001111111001111011100111100
00000000000000000000000000000000000000000000000001110000011111000111000111111110
00000000000000000000000000000000000000000000000011111111000111101110000111111110
00000000000000000000000000000000000000000000001111111111100111111110011111111110
00000000000000000000000000000000000000000000111111111011101111001110111111111110
00000000000000000000000000000000000000000000111111100011101111001111111100111110
00000000000000000000000000000000000000000001111100000111111111000111100111110110
00000000000000000000000000000000000000000000001110001111111111011110001111110010
00000000000000000000000000000000000000000000001111111111111111111110011111110000
00000000000000000000000000000000000000000000011111111011111111111111111111111000
00000000000000000000000000000000000000000000000001110011111111111111111111111100
00000000000000000000000000000000000000000000000000000001101111111111111111111000
00000000000000000000000000000000000000000000000000000001100111111111111111111000
00000000000000000000000000000000000000000000000000110001100110011111111111111000
00000000000000000000000000000000000000000000000001111011000011011111111111111110
00000000000000000000000000000000000000000000000001001111000011001100001111111110
00000000000000000000000000000000000000000000000000000110000110011100000111111110
00000000000000000000000000000000000000000000000000000011011100011100000111111110
00000000000000000000000000000000000000000000000000000011110000001110001111111010
00000000000000000000000000000000000000000000000000000011110000001100001101111110
00000000000000000000000000000000000000000000000000000111110000001100011000000000
00000000000000000000000000000000000000000000000000000100000000001000000000000000
00000000000000000000000000000000000000000000000000000000000000000000000000000000
00000000000000000000000000000000000000000000000000000000000000000000000000000000
00000000000000000000000000000000000000000000000000000000000000000000000000000000
00000000000000000000000000000000000000000000000000000000000000000000000000000000
00000000000000000000000000000000000000000000000000000000000000000000000000000000
00000000000000000000000000000000000000000000000000000000000000000000000000000000
00000000000000000000000000000000000000000000000000000000000000000000000000000000
00000000000000000000000000000000000000000000000000000000000000000000000000000000
00000000000000000000000000000000000000000000000000000000000000000000000000000000
00000000000000000000000000000000000000000000000000000000000000000000000000000000
00000000000000000000000000000000000000000000000000000000000000000000000000000000
00000000000000000000000000000000000000000000000000000000000000000000000000000000
00000000000000000000000000000000000000000000000000000000000000000000000000000000
00000000000000000000000000000000000000000000000000000000000000000000000000000000
00000000000000000000000000000000000000000000000000000000000000000000000000000000
00000000000000000000000000000000000000000000000000000000000000000000000000000000
00000000000000000000000000000000000000000000000000000000000000000000000000000000
