80 80
00000000000000000000000000000000000000000000000000000000000000000000000000000000
00000000000000000000000000000000000011001110110011111111111111111111111000000000
00000000000000000000000000000000000001000111110011111111111111111111111000001110
00000000000000000000000000000011000011110001100111111111111111111111111100001100
00000000000000000000000000000011100111111001111111111011111111111111111100011110
00000000000000000000000000001111111110011111111111110011111111111121111100111000
00000000000000000000000000001100011100001111111111110011111111111111111100111000
00000000000000000000000000000000001000000000001111110111111111111111111110111110
00000000000000000000000000000000000000000000001111111111111111111111111111101110
00000000000000000000000000000000011000001000111101111111111111101111111111110100
00000000000000000000000000001111111111111111111001111111111111101111111111111000
00000000000000000000000000000001000011001001111001111111111111111111111111111000
00000000000000000000000000000000000000000000111111111111011011111111100001111000
00000000000000000000000000000000000000000001111111111111011001111111100001111100
00000000000000000000000000000000000000000001111111111111111111111111110001111100
00000000000000000000000000000000000000011111111111111111111111101110111111111100
00000000000000000000000000000000000000001110011111110011111111001110001111110000
00000000000000000000000000000000000000000000000100011111111000001100000000000000
00000000000000000000000000000000000000000000000100011111111100111000000000000000
00000000000000000000000000000000000000000000000000111111111111111111111000000000
00000000000000000000000000000000000000000000000000110111111111001111111111000000
00000000000000000000000000000000000000000000000001100011111110000111111111000000
00000000000000000000000000000000000000000000000000000001111110001111111011100000
00000000000000000000000000000000000000000000000000000001111110011111110001110000
00000000000000000000000000000000000000000000000000000001111110011111111000110000
00000000000000000000000000000000000000000000000000000001111110011110011110110000
00000000000000000000000000000000000000000000000000000011011011000000000010000000
00000000000000000000000000000000000000000000000000000110010001100000000000000000
00000000000000000000000000000000000000000000000000000110010000000000000000000000
00000000000000000000000000000000000000000000000000000011010000000000000000000000
00000000000000000000000000000000000000000000000000000011111110000000000000000000
00000000000000000000000000000000000000000000000000000001111000000000000000000000
00000000000000000000000000000000000000000000000000000011100000000000000000000000
00000000000000000000000000000000000000000000000000000011000000000000000000000000
00000000000000000000000000000000000000000000000000000000000000000000000000000000
00000000000000000000000000000000000000000000000000000000000000000000000000000000
00000000000000000000000000000000000000000000000000000000000000000000000000000000
00000000000000000000000000000000000000000000000000000000000000000000000000000000
00000000000000000000000000000000000000000000000000000000000000000000000000000000
00000000000000000000000000000000000000000000000000000000000000000000000000000000
00000000000000000000000000000000000000000000000000000000000000000000000000000000
00000000000000000000000000000000000000000000000000000000000000000000000000000000
00000000000000000000000000000000000000000000000000000000000000000000000000000000
00000000000000000000000000000000000000000000000000000000000000000000000000000000
00000000000000000000000000000000000000000000000000000000000000000000000000000000
00000000000000000000000000000000000000000000000000000000000000000000000000000000
00000000000000000000000000000000000000000000000000000000000000000000000000000000
00000000000000000000000000000000000000000000000000000000000000000000000000000000
00000000000000000000000000000000000000000000000000000000000000000000000000000000
00000000000000000000000000000000000000000000000000000000000000000000000000000000
00000000000000000000000000000000000000000000000000000000000000000000000000000000
00000000000000000000000000000000000000000000000000000000000000000000000000000000
00000000000000000000000000000000000000000000000000000000000000000000000000000000
00000000000000000000000000000000000000000000000000000000000000000000000000000000
00000000000000000000000000000000000000000000000000000000000000000000000000000000
00000000000000000000000000000000000000000000000000000000000000000000000000000000
00000000000000000000000000000000000000000000000000000000000000000000000000000000
00000000000000000000000000000000000000000000000000000000000000000000000000000000
00000000000000000000000000000000000000000000000000000000000000000000000000000000
00000000000000000000000000000000000000000000000000000000000000000000000000000000
00000000000000000000000000000000000000000000000000000000000000000000000000000000
00000000000000000000000000000000000000000000000000000000000000000000000000000000
00000000000000000000000000000000000000000000000000000000000000000000000000000000
00000000000000000000000000000000000000000000000000000000000000000000000000000000
00000000000000000000000000000000000000000000000000000000000000000000000000000000
00000000000000000000000000000000000000000000000000000000000000000000000000000000
00000000000000000000000000000000000000000000000000000000000000000000000000000000
00000000000000000000000000000000000000000000000000000000000000000000000000000000
00000000000000000000000000000000000000000000000000000000000000000000000000000000
00000000000000000000000000000000000000000000000000000000000000000000000000000000
00000000000000000000000000000000000000000000000000000000000000000000000000000000
00000000000000000000000000000000000000000000000000000000000000000000000000000000
00000000000000000000000000000000000000000000000000000000000000000000000000000000
00000000000000000000000000000000000000000000000000000000000000000000000000000000
00000000000000000000000000000000000000000000000000000000000000000000000000000000
00000000000000000000000000000000000000000000000000000000000000000000000000000000
00000000000000000000000000000000000000000000000000000000000000000000000000000000
00000000000000000000000000000000000000000000000000000000000000000000000000000000
00000000000000000000000000000000000000000000000000000000000000000000000000000000
00000000000000000000000000000000000000000000000000000000000000000000000000000000
