80 80
00000000000000000000000000000000000000000000000000000000000000000000000000000000
00000000000000000000000000000000000000000000000000000000000000000000000000000000
00000000000000000000000000000000000000000000000000000000000000000000000000000000
00000000000000000000000000000000000000000000000000000000000000000000000000000000
00000000000000000000000000000000000000000000000000000000000000000000000000000000
00000000000000000000000000000000000000000000000000000000000000000000000000000000
00000000000000000000000000000000000000000000000000000000000000000000000000000000
00000000000000000000000000000000000000000000000000000000000000000000000000000000
00000000000000000000000000000000000000000000000000000000000000000000000000000000
00000000000000000000000000000000000000000000000000000000000000000000000000000000
00000000000000000000000000000000000000000000000000000000000000000000000000000000
00000000000000000000000000000000000000000000000000000000000000000000000000000000
00000000000000000000000000000000000000000000000000000000000000000000000000000000
00000000000000000000000000000000000000000000000000000000000000000000000000000000
00000000000000000000000000000000000000000000000000000000000000000000000000000000
00000000000000000000000000000000000000000000000000000000000000000000000000000000
00000000000000000000000000000000000000000000000000000000000000000000000000000000
00000000000000000000000000000000000000000000000000000000000000000000000000000000
00000000000000000000000000000000000000000000000000000000000000000000000000000000
00000000000000000000000000000000000000000000000000000000000000000000000000000000
00000000000000000000000000000000000000000000000000000000000000000000000000000000
00000000000000000000000000000000000000000000000000000000000000000000000000000000
00000000000000000000000000000000000000000000000000000000000000000000000000000000
00000000000000000000000000000000000000000000000000000000000000000000000000000000
00000000000000000000000000000000000000000000000000000000000000000000000000000000
00000000000000000000000000000000000000000000000000000000000000000000000000000000
00000000000000000000000000000000000000000000000000000000000000000000000000000000
00000000000000000000000000000000000000000000000000000000000000000000000000000000
00000000000000000000000000000000000000000000000000000000000000000000000000000000
00000000000000000000000000000000000000000000000000000000000000000000000000000000
00000000000000000000000000000000000000000000000000000000000000000000000000000000
00000000000000000000000000000000000000000000000000000000000000000000000000000000
00000000000000000000000000000000000000000000000000000000000000000000000000000000
00000000000000000000000000000000000000000000000000000000000000000000000000000000
00000000000000000000000000000000000000000000000000000000000000000000000000000000
00000000000000000000000000000000000000000000000000000000000000000000000000000000
00000000000000000000000000000000000000000000000000000000000000000000000000000000
00000000000000000000000000000000000000000000000000000000000000000000000000000000
00000000000000000000000000000000000000000000000000000000000000000000000000000000
00000000000000000000000000000000000000000000000000000000000000000000000000000000
00000000000000000000000000000000000000000000000000000000000000000000000000000000
00000000000000000000000000000000000000000000000000000000000000000000000000000000
00000000000000000000000000000000000000000000000000000000000000000000000000000000
00000000000000000000000000000000000000000000000000000000000000000000000000000000
00000000000000000000000000000000000000000000000000000000000000000000000000000000
00000000000000000000000000000000000000000000000000000000000000000000000000000000
00000000000000000000000000000001000000000000001100000010000000000000000000000000
00000000000000000000000000000001000000000000000111000010000000000000000000000000
00000000000000000001100000000001000100110000000110000011000000000000000000000000
00000000000000000000100000000001001111111000011110011001000000000000000000000000
00000000000000000000100011111111001111111100011011111001000000000000000000000000
00000000000000000000100000011100001111011000110011100111000000000000000000000000
00000000000000000011100000001110110111111001110010000011000000000000000000000000
00000000000000000011111100001111100011111111000110000011000000000000000000000000
00000000000000100011111110000111000111011111111111110011000000000000000000000000
00000000000000111111110111100111101111111101111111110001000000000000000000000000
00000000000000001112110001000111001111111000110001100001100000000000000000000000
00000000000000000111110000000011100111110000000001000001100000000000000000000000
00000000000000010111111000000001111111000111000001000001100000000000000000000000
00000000000000011110111110000011111111001111110001110001100000000000000000000000
00000000000000111111111111111111111111011100111111110011000110000000000000000000
00000000000000010011100001111110011111111000011111110001101100000000000000000000
00000000000000000111100000111110111111110000001111100001111100000000000000000000
00000000000000000000111100000111110111100001100111010000110000000000000000000000
00000000000000000000100110000011111111111011111111110000111000000000000000000000
00000000000000000000100011110111111111111100111111110011111111000000000000000000
00000000000000000000100000111110001111001000011111110110001000000000000000000000
00000000000000000000100000001100000000000000111111111100001000000000000000000000
00000000000000000000000000000000000111100111110000111100001000000000000000000000
00000000000000000000000000000000001111111100010000111110011100000000000000000000
00000000000000000000000000000000001110111100010001111111111111000111000000000000
00000000000000000000000000000000001110111000010011100000000011000011000000000000
00000000000000000000000000000000000100110000111111000000000011100110000000000000
00000000000000000000000000000000000000000000111011000000000011111100000000000000
00000000000000000000000000000000000000000000010001111110000011000000000000000000
00000000000000000000000000000000000000000000010001111111100010000000000000000000
00000000000000000000000000000000000000000000011001111000000000000000000000000000
00000000000000000000000000000000000000000000001011110000000000000000000000000000
00000000000000000000000000000000000000000000001110000000000000000000000000000000
00000000000000000000000000000000000000000000000000000000000000000000000000000000
