80 80
00000000000000000000000000000000000000000000000000000000000000000000000000000000
00000000000000000000000000000000000000000000000000000000000000000000000000000000
00000000000000000000000000000000000000000000000000000000000000000000000000000000
00000000000000000000000000000000000000000000000000000000000000000000000000000000
00000000000000000000000000000000000000000000000000000000000000000000000000000000
00000000000000000000000000000000000000000000000000000000000000000000000000000000
00000000000000000000000000000000000000000000000000000000000000000000000000000000
00000000000000000000000000000000000000000000000000000000000000000000000000000000
00000000000000000000000000000000000000000000000000000000000000000000000000000000
00000000000000000000000000000000000000000000000000000000000000000000000000000000
00000000000000000000000000000000000000000000000000000000000000000000000000000000
00000000000000000000000000000000000000000000000000000000000000000000000000000000
00000000000000000000000000000000000000000000000000000000000000000000000000000000
00000000000000000000000000000000000000000000000000000000000000000000000000000000
00000000000000000000000000000000000000000000000000000000000000000000000000000000
00000000000000000000000000000000000000000000000000000000000000000000000000000000
00000000000000000000000000000000000000000000000000000000000000000000000000000000
00000000000000000000000000000000000000000000000000000000000000000000000000000000
00000000000000000000000000000000000000000000000000000000000000000000000000000000
00000000000000000000000000000000000000000000000000000000000000000000000000000000
00000000000000000000000000000000000000000000000000000000000000000000000000000000
00000000000000000000000000000000000000000000000000000000000000000000000000000000
00000000000000000000000000000000000000000000000000000000000000000000000000000000
00000000000000000000000000000000000000000000000000000000000000000000000000000000
00000000000000000000000000000000000000000000000000000000000000000000000000000000
00000000000000000000000000000000000000000000000000000000000000000000000000000000
00000000000000000000000000000000000000000000000000000000000000000000000000000000
00000000000000000000000000000000000000000000000000000000000000000000000000000000
00000000000000000000000000000000000000000000000000000000000000000000000000000000
00000000000000000000000000000000000000000000000000000000000000000000000000000000
00000000000000000000000000000000000000000000000000000000000000000000000000000000
00000000000000000000000000000000000000000000000000000000000000000000000000000000
00000000000000000000000000000000000000000000000000000000000000000000000000000000
00000000000000000000000000000000000000000000000000000000000000000000000000000000
00000000000000000000000000000000000000000000000000000000000000000000000000000000
00000000000000000000000000000000000000000000000000000000000000000000000000000000
00000000000000000000000000000000000000000000000000000000000000000000000000000000
00000000000000000000000000000000000000000000000000000000000000000000000000000000
00000000000000110000000000000000000000000000000000000000000000000000000000000000
00000000000000110000100000000000000000000000000000000000000000000000000000000000
00000000011100110000100000000000000000000000000000000000000000000000000000000000
00000000110110011000110000000000000000000000000000000000000000000000000000000000
00000000100110011000010000000000000000000000000000000000000000000000000000000000
00000000010110011100110000100000000000000000000000000000000000000000000000000000
00110000111111111101110001100000000000000000000000000000000000000000000000000000
01111111111111111001110011000000000000000000000000000000000000000000000000000000
00000101111011111001110011000000000000000000000000000000000000000000000000000000
00000000000001111001111111000000000000000000000000000000000000000000000000000000
00000011000001111111100011100000000000000000000000000000000000000000000000000000
00000111110011111111100011110010000000000000000000000000000000000000000000000000
00000110111111111111111111111110000000000000000000000000000000000000000000000000
00001100000111111111111111111110000000000000000000000000000000000000000000000000
00011100000001111000001100011100000000000000000000000000000000000000000000000000
00000110000011110000000000011110000000000000000000000000000000000000000000000000
00000110001111111111110001111111000000000000000000000000000000000000000000000000
01001111011100111111111111111111101100000000000000000000000000000000000000000000
01111100111000011111111111100111111100000000000000000000000000000000000000000000
00110000110000000001011100000111111000000000000000000000000000000000000000000000
00000000110000000000000001100111101001111000000000000000000000000000000000000000
00111001111000001111100011111111001111001000000000000000000000000000000000000000
01111111001000111101110011111111001111001000000000000000000000000000000000000000
01000010001101100000111111111111001111011000000000000000000000000000000000000000
01000000001110000000001111111111000111110000000000000000000000000000000000000000
00100000000100000111000000011111100111110000000000000000000000000000000000000000
01111000000110011111100011111111111111111001000000000000000000000000000000000000
01101111111111111001111111111111111110111101110000000000000000000000000000000000
00000011110001100000111111111111111110101111000000000000000000000000000000000000
00000000110001000000011100011112111111111111000000000000000000000000000000000000
00000001111001000000011101111111111111111100000000000000000000000000000000000000
00000001111000000000111111111111111111001000000000000000000000000000000000000000
00000111001000000000111111111111111111001000000000000000000000000000000000000000
00000001001000000001100111111110110010011000000000000000000000000000000000000000
00000000001000000111001101100000000000010000000000000000000000000000000000000000
00000000011000000100001000000000000000000000000000000000000000000000000000000000
00000000001000011100000000000000000000000000000000000000000000000000000000000000
00000000001000010110100000000000000000000000000000000000000000000000000000000000
00000000000000010011100000000000000000000000000000000000000000000000000000000000
00000000000000010000000000000000000000000000000000000000000000000000000000000000
00000000000000010000000000000000000000000000000000000000000000000000000000000000
00000000000000000000000000000000000000000000000000000000000000000000000000000000
