80 80
00000000000000000000000000000000000000000000000000000000000000000000000000000000
00000000000000000000000000000000000000000000000000000000000000000000000000000000
00000000000000000000000000000000000000000000000000000000000000000000000000000000
00000000000000000000000000000000000000000000000000000000000000000000000000000000
00000000000000000000000000000000000000000000000000000000000000000000000000000000
00000000000000000000000000000000000000000000000000000000000000000000000000000000
00000000000000000000000000000000000000000000000000000000000000000000000000000000
00000000000000000000000000000000000000000000000000000000000000000000000000000000
00000000000000000000000000000000000000000000000000000000000000000000000000000000
00000000000000000000000000000000000000000000000000000000000000000000000000000000
00000000000000000000000000000000000000000000000000000000000000000000000000000000
00000000000000000000000000000000000000000000000000000000000000000000000000000000
00000000000000000000000000000000000000000000000000000000000000000000000000000000
00000000000000000000000000000000000000000000000000000000000000000000000000000000
00000000000000000000000000000000000000000000000000000000000000000000000000000000
00000000000000000000000000000000000000000000000000000000000000000000000000000000
00000000000000000000000000000000000000000000000000000000000000000000000000000000
00000000000000000000000000000000000000000000000000000000000000000000000000000000
00000000000000000000000000000000000000000000000000000000000000000000000000000000
00000000000000000000000000000000000000000000000000000000000000000000000000000000
00000000000000000000000000000000000000000000000000000000000000000000000000000000
00000000000000000000000000000000000000000000000000000000000000000000000000000000
00000000000000000000000000000000000000000000000000000000000000000000000000000000
00000000000000000000000000000000000000000000000000000000000000000000000000000000
00000000000000000000000000000000000000000000000000000000000000000000000000000000
00000000000000000000000000000000000000000000000000000000000000000000000000000000
00000000000000000000000000000000000000000000000000000000000000000000000000000000
00000000000000000000000000000000000000000000000000000000000000000000000000000000
00000000000000000000000000000000000000000000000000001000000000000000000000000000
00000000000000000000000000000000000000000000000000001100000000000000000000110000
00000000000000000000000000000000000000000000000001111111100000000000000000111110
00000000000000000000000000000000000000000000000000001100000000000000000000011110
00000000000000000000000000000000000000000000000000000100000000000000000000000110
00000000000000000000000000000000000000000000000000000100000000000110000000000110
00000000000000000000000000000000000000000000000000000110000110000111101110011110
00000000000000000000000000000000000000000000000000000011110111001110111111111110
00000000000000000000000000000000000000000000000000000000111110001100011111110110
00000000000000000000000000000000000000000000000000000000011110001111111111110010
00000000000000000000000000000000000000000000000000000000000110001111111111110000
00000000000000000000000000000000000000000000000000000000000110011110001110111000
00000000000000000000000000000000000000000000000000000000000111111111111100111000
00000000000000000000000000000000000000000000000000000000000011111111110000111010
00000000000000000000000000000000000000000000000000000000000011111111100000111110
00000000000000000000000000000000000000000000000000000000000011111101100001111110
00000000000000000000000000000000000000000000000000000000000111111100111011011110
00000000000000000000000000000000000000000000000000000000000111111110011111111010
00000000000000000000000000000000000000000000000000000000000111111110001111110000
00000000000000000000000000000000000000000000001100000000000111111000000000110000
00000000000000000000000000000000000000000000011100001111000011111100000000011000
00000000000000000000000000000000000000000000011111110011000011111100111000111000
00000000000000000000000000000000000000000000011111110011100111111110011110111000
00000000000000000000000000000000000000000000110001110001100111111110001111110010
00000000000000000000000000000000000000000000000000111011111111111110000000000010
00000000000000000000000000000000000000000000000000011111111111111111000000000110
00000000000000000000000000000000000000000000000000011111111111111111111111111110
00000000000000000000000000000000000000000000000001111111111111111111111111111110
00000000000000000000000000000000000000000000000011000001111111111111111111111110
00000000000000000000000000000000000000000000000000000000011111111111110011110010
00000000000000000000000000000000000000000000000000110000011111111110001111111110
00000000000000000000000000000000000000000000111000110000111111111110011111111110
00000000000000000000000000000000000000000000110000100011100111111110111111111110
00000000000000000000000000000000000000000001110000110111000111111111111111111110
00000000000000000000000000000000000000000000110000111110001111111111111011121110
00000000000000000000000000000000000000000000110000011111001111111111111111111110
00000000000000000000000000000000000000000000110000110011111111111111111111111100
00000000000000000000000000000000000000000000111101110011111111111111011111111110
00000000000000000000000000000000000000000000011111100011111111111111011111111110
00000000000000000000000000000000000000000000000111110011011111111111111111001110
00000000000000000000000000000000000000000000000111110011001111011000111111100000
00000000000000000000000000000000000000000000001111100001001110011101101111111000
00000000000000000000000000000000000000000000111111110001001111001111111100111110
00000000000000000000000000000000000000000011100110010001101111000111111000011110
00000000000000000000000000000000000000000011000000000001111110000011110000011110
00000000000000000000000000000000000000000000000000011000111110001111110000010010
00000000000000000000000000000000000000000000000001111101110111111110110000010010
00000000000000000000000000000000000000000000000001110111111111111110011100111000
00000000000000000000000000000000000000000000000000001111111110111110001100011000
00000000000000000000000000000000000000000000000000000110011000110011000111001000
00000000000000000000000000000000000000000000000000000110010000100000011111111000
00000000000000000000000000000000000000000000000000000000000000000000000000000000
