80 80
00000000000000000000000000000000000000000000000000000000000000000000000000000000
00000000000000000000000000000000000000000000000000000000000000000000000000011110
00000000000000000000000000000000000000000000000000000000000000000000000000001110
00000000000000000000000000000000000000000000000000000000000000000000000001100110
00000000000000000000000000000000000000000000000000000000000000000000001111111110
00000000000000000000000000000000000000000000000000000000000000000000011100111100
00000000000000000000000000000000000000000000000000000000000000000000001000011100
00000000000000000000000000000000000000000000000000000000000000000000000000001000
00000000000000000000000000000000000000000000000000000000000000000100000000001000
00000000000000000000000000000000000000000000000000000000000000001100001000011100
00000000000000000000000000000000000000000000000000000000000000000100001000111110
00000000000000000000000000000000000000000000000000000000000000000110001101110110
00000000000000000000000000000000000000000000000000000000001100000010000111000110
00000000000000000000000000000000000000000000000000000000001110000010000000001100
00000000000000000000000000000000000000000000000000000000000011000110001100011000
00000000000000000000000000000000000000000000000000000000000010001110011111111010
00000000000000000000000000000000000000000000000000000000000110001100011011111010
00000000000000000000000000000000000000000000000000000000000110001100111121111110
00000000000000000000000000000000000000000000000000000000001110001101111111111100
00000000000000000000000000000000000000000000000000000000111111001111111101111000
00000000000000000000000000000000000000000000000000000011111111111111111111111100
00000000000000000000000000000000000000000000000000000010000111111111001111111110
00000000000000000000000000000000000000000000000100000000000111001111111111000000
00000000000000000000000000000000000000000000011100000000001000011100111111110000
00000000000000000000000000000000000000000000010001000001111110111100011111110000
00000000000000000000000000000000000000000000010011111011101111111110001110110000
00000000000000000000000000000000000000000000011110111111000010001110011110111010
00000000000000000000000000000000000000000000001100000111000110011111001111111110
00000000000000000000000000000000000000000000000000100011011111111011000011111110
00000000000000000000000000000000000000000000000001110011111111110011111010011110
00000000000000000000000000000000000000000000000001110011111111111111111110111110
00000000000000000000000000000000000000000000000000111111100000000000000111110110
00000000000000000000000000000000000000000000000000111111100000000000000001000000
00000000000000000000000000000000000000000000000001110011100000000000000000000000
00000000000000000000000000000000000000000000001111110001100000000000000000000000
00000000000000000000000000000000000000000000111001110011100000000000000000000000
00000000000000000000000000000000000000000000000001110011000000000000000000000000
00000000000000000000000000000000000000000000000000000011100000000000000000000000
00000000000000000000000000000000000000000000000000000000110000000000000000000000
00000000000000000000000000000000000000000000000000000000000000000000000000000000
00000000000000000000000000000000000000000000000000000000000000000000000000000000
00000000000000000000000000000000000000000000000000000000000000000000000000000000
00000000000000000000000000000000000000000000000000000000000000000000000000000000
00000000000000000000000000000000000000000000000000000000000000000000000000000000
00000000000000000000000000000000000000000000000000000000000000000000000000000000
00000000000000000000000000000000000000000000000000000000000000000000000000000000
00000000000000000000000000000000000000000000000000000000000000000000000000000000
00000000000000000000000000000000000000000000000000000000000000000000000000000000
00000000000000000000000000000000000000000000000000000000000000000000000000000000
00000000000000000000000000000000000000000000000000000000000000000000000000000000
00000000000000000000000000000000000000000000000000000000000000000000000000000000
00000000000000000000000000000000000000000000000000000000000000000000000000000000
00000000000000000000000000000000000000000000000000000000000000000000000000000000
00000000000000000000000000000000000000000000000000000000000000000000000000000000
00000000000000000000000000000000000000000000000000000000000000000000000000000000
00000000000000000000000000000000000000000000000000000000000000000000000000000000
00000000000000000000000000000000000000000000000000000000000000000000000000000000
00000000000000000000000000000000000000000000000000000000000000000000000000000000
00000000000000000000000000000000000000000000000000000000000000000000000000000000
00000000000000000000000000000000000000000000000000000000000000000000000000000000
00000000000000000000000000000000000000000000000000000000000000000000000000000000
00000000000000000000000000000000000000000000000000000000000000000000000000000000
00000000000000000000000000000000000000000000000000000000000000000000000000000000
00000000000000000000000000000000000000000000000000000000000000000000000000000000
00000000000000000000000000000000000000000000000000000000000000000000000000000000
00000000000000000000000000000000000000000000000000000000000000000000000000000000
00000000000000000000000000000000000000000000000000000000000000000000000000000000
00000000000000000000000000000000000000000000000000000000000000000000000000000000
00000000000000000000000000000000000000000000000000000000000000000000000000000000
00000000000000000000000000000000000000000000000000000000000000000000000000000000
00000000000000000000000000000000000000000000000000000000000000000000000000000000
00000000000000000000000000000000000000000000000000000000000000000000000000000000
00000000000000000000000000000000000000000000000000000000000000000000000000000000
00000000000000000000000000000000000000000000000000000000000000000000000000000000
00000000000000000000000000000000000000000000000000000000000000000000000000000000
00000000000000000000000000000000000000000000000000000000000000000000000000000000
00000000000000000000000000000000000000000000000000000000000000000000000000000000
00000000000000000000000000000000000000000000000000000000000000000000000000000000
00000000000000000000000000000000000000000000000000000000000000000000000000000000
00000000000000000000000000000000000000000000000000000000000000000000000000000000
