80 80
00000000000000000000000000000000000000000000000000000000000000000000000000000000
00000000000000000000000000000000000000000000011111100000000011111000000000000000
00000000000000000000000000000000000000000000110111110100000000110000000000000000
00000000000000000000000000000000000000000001100111111111100000111000000000000000
00000000000000000000000000000000000000000011001111111111111110011100000000000000
00000000000000000000000000000000000000111111111111111111111111001110000000000000
00000000000000000000000000000000000000000100000011111111111111100111000000000000
00000000000000000000000000000000000000000000000110000100001111100001100000000000
00000000000000000000000000000000000000000000000110000010000111110000100000000000
00000000000000000000000000000000000000000000000001100111000111111111101100000000
00000000000000000000000000000000000000000000010011111111100111001111111000000000
00000000000000000000000000000000000000000000011000111011101110000111111000000000
00000000000000000000000000000000000000000000011100111111111000000011100000000000
00000000000000000000000000000000000000000000011100111111111000000111100000000000
00000000000000000000000000000000000000000000011111111111111111001110110000010000
00000000000000000000000000000000000000000000111111111111111111101110011100010000
00000000000000000000000000000000000000000000100111111111111111111110000100010000
00000000000000000000000000000000000000000000000010001111111000111110000000011000
00000000000000000000000000000000000000000000000000000111111100011111000000011000
00000000000000000000000000000000000000000000000001000011100110001111111000011000
00000000000000000000000000000000000000000000000001110011100111011111011100111000
00000000000000000000000000000000000000000000000000011011100011111110001110111000
00000000000000000000000000000000000000000000000000001111100011111000001111111000
00000000000000000000000000000000000000000000000000011111110011111000111000010000
00000000000000000000000000000000000000000000000000111111110011111101111000110000
00000000000000000000000000000000000000000000000001111111110111001111011100110000
00000000000000000000000000000000000000000000001111101111111110000111011000010000
00000000000000000000000000000000000000000000001111000111111110000111110000000000
00000000000000000000000000000000000000000000000001000111111111111111000000000000
00000000000000000000000000000000000000000000110001101111111111111110001100000000
00000000000000000000000000000000000000000000010000111111100111111110011100000000
00000000000000000000000000000000000000000000011000111111100111111111111000000000
00000000000000000000000000000000000000000000001101111111111111100001110000000000
00000000000000000000000000000000000000000000010111111111100111000001111110000000
00000000000000000000000000000000000000000001111111110111000110001111111110000000
00000000000000000000000000000000000000001111111111110111100010001111121111111100
00000000000000000000000000000000000000000100001111111001100011001111111111001100
00000000000000000000000000000000000000000000000000001111110111000111111110000100
00000000000000000000000000000000000000000000000000111111111111100011110000000000
00000000000000000000000000000000000000000000000111110001111111100111110000000000
00000000000000000000000000000000000000000000111111111111111111101110111100000000
00000000000000000000000000000000000000000000000001111110001111111100000000000000
00000000000000000000000000000000000000000000000001111000001111111100000000000000
00000000000000000000000000000000000000000000000000000000011111000110000010000000
00000000000000000000000000000000000000000000000001000000111110000111001110000000
00000000000000000000000000000000000000000000000001111111100111001111111100000000
00000000000000000000000000000000000000000000000000011111000011000101111000000000
00000000000000000000000000000000000000000000000000000100000001000001101100000000
00000000000000000000000000000000000000000000000000000101000001000001000100000000
00000000000000000000000000000000000000000000011111101101100011000110000000000000
00000000000000000000000000000000000000000000111001111111000010000100000000000000
00000000000000000000000000000000000000000000110000111111000110001100000000000000
00000000000000000000000000000000000000000001100000000111000110001100000000000000
00000000000000000000000000000000000000000001000000000111100110011111000000000000
00000000000000000000000000000000000000000011100011111111110110111101100000000000
00000000000000000000000000000000000000011110111001111111100011110101100000000000
00000000000000000000000000000000000000000000001100011111100011100111000000000000
00000000000000000000000000000000000000000000001100000001100011100110000000000000
00000000000000000000000000000000000000000000011000000001110011001100000000000000
00000000000000000000000000000000000000000000011000011001100111000100000000000000
00000000000000000000000000000000000000000000110000111111000111000100000000000000
00000000000000000000000000000000000000000000000000000111001111000100000000000000
00000000000000000000000000000000000000000000000000000110001001000000000000000000
00000000000000000000000000000000000000000000000000001100001000000000000000000000
00000000000000000000000000000000000000000000000000011000001000000000000000000000
00000000000000000000000000000000000000000000000000110000000000000000000000000000
00000000000000000000000000000000000000000000000000000000000000000000000000000000
00000000000000000000000000000000000000000000000000000000000000000000000000000000
00000000000000000000000000000000000000000000000000000000000000000000000000000000
00000000000000000000000000000000000000000000000000000000000000000000000000000000
00000000000000000000000000000000000000000000000000000000000000000000000000000000
00000000000000000000000000000000000000000000000000000000000000000000000000000000
00000000000000000000000000000000000000000000000000000000000000000000000000000000
00000000000000000000000000000000000000000000000000000000000000000000000000000000
00000000000000000000000000000000000000000000000000000000000000000000000000000000
00000000000000000000000000000000000000000000000000000000000000000000000000000000
00000000000000000000000000000000000000000000000000000000000000000000000000000000
00000000000000000000000000000000000000000000000000000000000000000000000000000000
00000000000000000000000000000000000000000000000000000000000000000000000000000000
00000000000000000000000000000000000000000000000000000000000000000000000000000000
