80 80
00000000000000000000000000000000000000000000000000000000000000000000000000000000
00000000000000000000000000000000000001000000000000000001100000000000001111100000
00000000000000000000000000000000000011000000000000000000110000000000000111000000
00000000000000000000000100000001100110000000000000000000011000000000011110000000
00000000000000000000011111000011000100000110000001100110011100000100001101100000
00000000000000000001111001000111000100011100000001111111111111000100001000111000
00000000000000000001010001100111000110110000000000010000111011101100011000011000
00000000000000000000011111100100011111100000000000000000011000111000111111110000
00000000000000000000111111001100001111110000000000000000111110000001101110111000
00000000000000000000100111111110000111011000100001100111110111000111001100011000
00000000000000000000100111111111000111001000111001110111110111001110001000010000
00000000000000000000110000000011101100001000011000111111100111001100011000110000
00000000000000000000010000000011111000111000011000001111100111111000011011000000
00000000000000000000010000001111110000011000110000000011111111111100011110000000
00100000000000110000110001111011111000111000110111100011111111111100011100000000
01111111100000010000100011111111111110011100111111110011111111111110111100000000
01100001110000011001100111111100010110001100011100110001111111211111111100000000
00100000000000011111000111100000010010000011011100000001111111111111111100000000
00111000000000000010011111000000111111000001111100011110111111111100001110000110
00111111101100111101111111000011111111100111111111111111111111111100001111001110
00001111111100111001110011101111001111111111111111111111111111111100001001111110
00001100111000111011110001111111000111111000111011111101111111110110001001100000
00000000100000110011111000000000001111110000000011110000011111100001111000000000
00000001110000110010111111000001011111111011110011100000111100110000011100000000
00000011111000110111110011000011001110011111111111100001111110011000001100000000
00001110011000011111110011100110001110011111111111110011111111111110001000000000
00001000001100011111000001100011001100011111111110110011111011100010011000000000
00011000001100001000000010000011001110001011011111111011111011100000110000000000
00001100111000000100000010000011110110000010001111111111111111110000000000000000
00000111111000001100000011001111111110011011011111111111001111110100000000000000
00001111111111111111110011111111111110011111111111111111111111111110000000000000
01001110001111111110000011111001111100000111110111110001110000000100000000000000
01111110001111110100000111110000001100000001111111110000110000000000000000000000
01111100011110011100000011100000000100000000111100110000100000000000000000000000
01111100001100011110000001110000000110000000111100110001100000000000000000000000
01111100001100111111110011111111000111111111111000100001100000000000000000000000
00100110011000110000111111011000001111100011111001100001100000000000000000000000
00110011111001000001111110010000000111000000011001000000100000000000000000000000
01110001111011000111110000000000000011100000011110000000000000000000000000000000
01110111111110011000110000000000000010000000010111000000000000000000000000000000
01111111111111111001100000000000000000000000010011110000000000000000000000000000
01111000111111110011000000000000000000000000010000000000000000000000000000000000
00110000101100000011000000000000000000000000000000000000000000000000000000000000
00000000001000001111000000000000000000000000000000000000000000000000000000000000
00000000001000011000000000000000000000000000000000000000000000000000000000000000
00000000011000010000000000000000000000000000000000000000000000000000000000000000
00000000001100000000000000000000000000000000000000000000000000000000000000000000
00000000000000000000000000000000000000000000000000000000000000000000000000000000
00000000000000000000000000000000000000000000000000000000000000000000000000000000
00000000000000000000000000000000000000000000000000000000000000000000000000000000
00000000000000000000000000000000000000000000000000000000000000000000000000000000
00000000000000000000000000000000000000000000000000000000000000000000000000000000
00000000000000000000000000000000000000000000000000000000000000000000000000000000
00000000000000000000000000000000000000000000000000000000000000000000000000000000
00000000000000000000000000000000000000000000000000000000000000000000000000000000
00000000000000000000000000000000000000000000000000000000000000000000000000000000
00000000000000000000000000000000000000000000000000000000000000000000000000000000
00000000000000000000000000000000000000000000000000000000000000000000000000000000
00000000000000000000000000000000000000000000000000000000000000000000000000000000
00000000000000000000000000000000000000000000000000000000000000000000000000000000
00000000000000000000000000000000000000000000000000000000000000000000000000000000
00000000000000000000000000000000000000000000000000000000000000000000000000000000
00000000000000000000000000000000000000000000000000000000000000000000000000000000
00000000000000000000000000000000000000000000000000000000000000000000000000000000
00000000000000000000000000000000000000000000000000000000000000000000000000000000
00000000000000000000000000000000000000000000000000000000000000000000000000000000
00000000000000000000000000000000000000000000000000000000000000000000000000000000
00000000000000000000000000000000000000000000000000000000000000000000000000000000
00000000000000000000000000000000000000000000000000000000000000000000000000000000
00000000000000000000000000000000000000000000000000000000000000000000000000000000
00000000000000000000000000000000000000000000000000000000000000000000000000000000
00000000000000000000000000000000000000000000000000000000000000000000000000000000
00000000000000000000000000000000000000000000000000000000000000000000000000000000
00000000000000000000000000000000000000000000000000000000000000000000000000000000
00000000000000000000000000000000000000000000000000000000000000000000000000000000
00000000000000000000000000000000000000000000000000000000000000000000000000000000
00000000000000000000000000000000000000000000000000000000000000000000000000000000
00000000000000000000000000000000000000000000000000000000000000000000000000000000
00000000000000000000000000000000000000000000000000000000000000000000000000000000
00000000000000000000000000000000000000000000000000000000000000000000000000000000
