80 80
00000000000000000000000000000000000000000000000000000000000000000000000000000000
00000000000000000000000000000000000000000000000000000000000000000000000000000000
00000000000000000000000000000000000000000000000000000000000000000000000000000000
00000000000000000000000000000000000000000000000000000000000000000000000000000000
00000000000000000000000000000000000000000000000000000000000000000000000000000000
00000000000000000000000000000000000000000000000000000000000000000000000000000000
00000000000000000000000000000000000000000000000000000000000000000000000000000000
00000000000000000000000000000000000000000000000000000000000000000000000000000000
00000000000000000000000000000000000000000000000000000000000000000000000000000000
00000000000000000000000000000000000000000000000000000000000000000000000000000000
00000000000000000000000000000000000000000000000000000000000000000000000000000000
00000000000000000000000000000000000000000000000000000000000000000000000000000000
00000000000000000000000000000000000000000000000000000000000000000000000000000000
00000000000000000000000000000000000000000000000000000000000000000000000000000000
00000000000000000000000000000000000000000000000000000000000000000000000000000000
00000000000000000000000000000000000000000000000000000000000000000000000000000000
00000000000000000000000000000000000000000000000000000000000000000000000000000000
00000000000000000000000000000000000000000000000000000000000000000000000000000000
00000000000000000000000000000000000000000000000000000000000000000000000000000000
00000000000000000000000000000000000000000000000000000000000000000000000000000000
00000000000000000000000000000000000000000000000000000000000000000000000000000000
00000000000000000000000000000000000000000000000000000000000000000000000000000000
00000000000000000000000000000000000000000000000000000000000000000000000000000000
00000000000000011000000000000000000000000000000000000000000000000000000000000000
00000000000000110000000001000000000000000000000000000000000000000000000000000000
00000000000000011001110011000000000000000000000000000000000000000000000000000000
00000000000000011100011111000000000000000000000000000000000000000000000000000000
00000000000000001110001111000000000000000000000000000000000000000000000000000000
00000000000000011110000011000000000000000000000000000000000000000000000000000000
00000000001000011000000011000000000000000000000000000000000000000000000000000000
00001111111101110000111011100000000000000000000000000000000000000000000000000000
00000011001111110000001101100000000000000000000000000000000000000000000000000000
00000000001111110000001101111000000000000000000000000000000000000000000000000000
00000000000000110000001101110000000000000000000000000000000000000000000000000000
00000000000000111000111101111000000000000000000000000000000000000000000000000000
00000000000000111001111111111111000000000000000000000000000000000000000000000000
00000000000000111000111111000100000000000000000000000000000000000000000000000000
00000001000001110000110011011100000000000000000000000000000000000000000000000000
00000111000001110000110000111110000000000000000000000000000000000000000000000000
00000110010010110000110001100010000000000000000000000000000000000000000000000000
00000100111110110001100001000110000000000000000000000000000000000000000000000000
00000111111110110001110011000000000000000000000000000000000000000000000000000000
01111111100111110000111100000000000000000000000000000000000000000000000000000000
01111111001111100000111000011000000000000000000000000000000000000000000000000000
01111110011100110000111001111110000000000000000000000000000000000000000000000000
01111110011111111101111111111110000000000000000000000000000000000000000000000000
00111110001111111111100111011111000000000000000000000000000000000000000000000000
00111110000111111110000010001111111000000000000000000000000000000000000000000000
00111111111001111110000010000111111000000000000000000000000000000000000000000000
01111111111101111011100111000011000000000000000000000000000000000000000000000000
01101112111101111111111111111110000000000000000000000000000000000000000000000000
01101111111000111110111101111100000000000000000000000000000000000000000000000000
01111111111000111100111000111000001000000000000000000000000000000000000000000000
01011111110001111101110000000000011000000000000000000000000000000000000000000000
00001100111111111111110011100111110000000000000000000000000000000000000000000000
00001110111111111111110011101111000000000000000000000000000000000000000000000000
00000110001111111111110001111110000000000000000000000000000000000000000000000000
00100110000011000110010000011110000000000000000000000000000000000000000000000000
00100111000011000010001000111111100000000000000000000000000000000000000000000000
01111111111111110011111101111111000000000000000000000000000000000000000000000000
01111111111111111111111111100111000000000000000000000000000000000000000000000000
01111100111110011111111111000001000000000000000000000000000000000000000000000000
00111000111100000110001100000000000000000000000000000000000000000000000000000000
00111000111000000110011100000000000000000000000000000000000000000000000000000000
01011111111101110111111001111100000000000000000000000000000000000000000000000000
01011111111111111111111111111111000000000000000000000000000000000000000000000000
01011111001111111111111111011111000000000000000000000000000000000000000000000000
01110111000011111100000010000000000000000000000000000000000000000000000000000000
01101111000011111000000000000000000000000000000000000000000000000000000000000000
01001111110010011100000000000000000000000000000000000000000000000000000000000000
01000110111110111000000000000000000000000000000000000000000000000000000000000000
01000110001111110000000000000000000000000000000000000000000000000000000000000000
01000011001111100000000000000000000000000000000000000000000000000000000000000000
01100000111111100000000000000000000000000000000000000000000000000000000000000000
01110100111001110000000000000000000000000000000000000000000000000000000000000000
01111110011110111000000000000000000000000000000000000000000000000000000000000000
00110100001110110000000000000000000000000000000000000000000000000000000000000000
00010000000011110000000000000000000000000000000000000000000000000000000000000000
00011000000011100000000000000000000000000000000000000000000000000000000000000000
00000000000000000000000000000000000000000000000000000000000000000000000000000000
