80 80
00000000000000000000000000000000000000000000000000000000000000000000000000000000
00000000000000000000000000000000000000000000000000000000000000000000000000000000
00000000000000000000000000000000000000000000000000000000000000000000000000000000
00000000000000000000000000000000000000000000000000000000000000000000000000000000
00000000000000000000000000000000000000000000000000000000000000000000000000000000
00000000000000000000000000000000000000000000000000000000000000000000000000000000
00000000000000000000000000000000000000000000000000000000000000000000000000000000
00000000000000000000000000000000000000000000000000000000000000000000000000000000
00000000000000000000000000000000000000000000000000000000000000000000000000000000
00000000000000000000000000000000000000000000000000000000000000000000000000000000
00000000000000000000000000000000000000000000000000000000000000000000000000000000
00000000000000000000000000000000000000000000000000000000000000000000000000000000
00000000000000000000000000000000000000000000000000000000000000000000000000000000
00000000000000000000000000000000000000000000000000000000001000000000000000000000
00000000000000000000000000000000000000000000000000100000011000000000000000000000
00000000000000000000000000000000000000000000000000100000001111000000000000000000
00000000000000000000000000000000000000000000000000100000001000000000000000000000
00000000000000000000000000000000000000000000000000100000001111100000000000000000
00000000000000000000000000000000000000000000000000110000000011000000000000000000
00000000000000000000000000000000000000000000000000111101000010000000000000000000
00000000000000000000000000000000000000000000000000101111000111000000000000000000
00000000000000000000000000000000000000000000000000100101000111100000000000000000
00000000000000000000000000000000000000000000000000001100000001100000000000000000
00000000000000000000000000000000000000000000000000001100000001100000000000000000
00000000000000000000000000000000000000000000000000111111100111111000000000000000
00000000000000000000000000000000000000000000000001111111110111111110000000000000
00000000000000000000000000000000000000000000000111111111111111110010000000000000
00000000000000000000000000000000000000000000000000001112111111110000000000000000
00000000000000000000000000000000000000000000011000011111111001110000000000000000
00000000000000000000000000000000000000000000011000111111111111111100000000000000
00000000000000000000000000000000000000001100111001110011111111111110000000000000
00000000000000000000000000000000000000000100111111100011111111110110000000000000
00000000000000000000000000000000000000000100011111100001111100011110000000000000
00000000000000000000000000000000000000000110000001111101111100011110000000000000
00000000000000000000000000000000000000000111100000111111111110001110000000000000
00000000000000000000000000000000000000000001111001111111111111001111000000000000
00000000000000000000000000000000000000000000001101110111011111000111000000000000
00000000000000000000000000000000000000000000000111110000011111000001000000000000
00000000000000000000000000000000000000000111000001111100001111100000000000000000
00000000000000000000000000000000000000000101100001111111111111000000000000000000
00000000000000000000000000000000000000000000111111111111111111000000000000000000
00000000000000000000000000000000000000000000001111111111111111000000000000000000
00000000000000000000000000000000000000000000000011111000011111100000000000000000
00000000000000000000000000000000000000000000000001111000000100110000000000000000
00000000000000000000000000000000000000000000000001111111000000000000000000000000
00000000000000000000000000000000000000000000000001111111100000000000000000000000
00000000000000000000000000000000000000000000001111111100110000000000000000000000
00000000000000000000000000000000000000000000000111111000000000000000000000000000
00000000000000000000000000000000000000000000000000110000000000000000000000000000
00000000000000000000000000000000000000000000000000100000000000000000000000000000
00000000000000000000000000000000000000000000000000100000000000000000000000000000
00000000000000000000000000000000000000000000000000100100000000000000000000000000
00000000000000000000000000000000000000000000000000111100000000000000000000000000
00000000000000000000000000000000000000000000000000010000000000000000000000000000
00000000000000000000000000000000000000000000000000110000000000000000000000000000
00000000000000000000000000000000000000000000000000100000000000000000000000000000
00000000000000000000000000000000000000000000000000000000000000000000000000000000
00000000000000000000000000000000000000000000000000000000000000000000000000000000
00000000000000000000000000000000000000000000000000000000000000000000000000000000
00000000000000000000000000000000000000000000000000000000000000000000000000000000
00000000000000000000000000000000000000000000000000000000000000000000000000000000
00000000000000000000000000000000000000000000000000000000000000000000000000000000
00000000000000000000000000000000000000000000000000000000000000000000000000000000
00000000000000000000000000000000000000000000000000000000000000000000000000000000
00000000000000000000000000000000000000000000000000000000000000000000000000000000
00000000000000000000000000000000000000000000000000000000000000000000000000000000
00000000000000000000000000000000000000000000000000000000000000000000000000000000
00000000000000000000000000000000000000000000000000000000000000000000000000000000
00000000000000000000000000000000000000000000000000000000000000000000000000000000
00000000000000000000000000000000000000000000000000000000000000000000000000000000
00000000000000000000000000000000000000000000000000000000000000000000000000000000
00000000000000000000000000000000000000000000000000000000000000000000000000000000
00000000000000000000000000000000000000000000000000000000000000000000000000000000
00000000000000000000000000000000000000000000000000000000000000000000000000000000
00000000000000000000000000000000000000000000000000000000000000000000000000000000
00000000000000000000000000000000000000000000000000000000000000000000000000000000
00000000000000000000000000000000000000000000000000000000000000000000000000000000
00000000000000000000000000000000000000000000000000000000000000000000000000000000
00000000000000000000000000000000000000000000000000000000000000000000000000000000
00000000000000000000000000000000000000000000000000000000000000000000000000000000
