80 80
00000000000000000000000000000000000000000000000000000000000000000000000000000000
00000000001000011111110111111111111111000000000000000000000000000000000000000000
00000000001100010011111100001111111111110000000000000000000000000000000000000000
00000000000110100011111100011111100011111000000000000000000000000000000000000000
00000000001101110111111111111111100110001100000000000000000000000000000000000000
00000000001000111111111111111111111111111000000000000000000000000000000000000000
00000000011000011111111111100111111111111000000000000000000000000000000000000000
00000000110000011111111100000111111111000000000000000000000000000000000000000000
00000000111111111111111100000011111111000110000000000000000000000000000000000000
00000000111111111111111111110011111111001100000000000000000000000000000000000000
00000000111111111111111111111111111111001000000000000000000000000000000000000000
00000000111111111111111111111110011111011000000000000000000000000000000000000000
00000000111111111111111111111111111111110000000000000000000000000000000000000000
00010000011111001111111111111111111010000000000000000000000000000000000000000000
00011000011111111001111111100111111111000000000000000000000000000000000000000000
00001110011111111111110111111111111111111000000000000000000000000000000000000000
00000111001111111111110011111110001111000000000000000000000000000000000000000000
00000111000111111111111111111100000000000000000000000000000000000000000000000000
00001111100011111000111111111100000111000000000000000000000000000000000000000000
00001101111111111001111111111110001111100000000000000000000000000000000000000000
00001111111111111111111111101111001110000000000000000000000000000000000000000000
00000011111110111111111111101111101110000000000000000000000000000000000000000000
00000001000000011111111111111101111100000000000000000000000000000000000000000000
00000001100111111111121111111000110100000000000000000000000000000000000000000000
00000001101111111111111111110111100100000000000000000000000000000000000000000000
00000111111101111111111111111111000100000000000000000000000000000000000000000000
00000011111000111111111111101111000100000000000000000000000000000000000000000000
00000000110000111111111111101111100000000000000000000000000000000000000000000000
00000000110000100111111001101111110000000000000000000000000000000000000000000000
00000000011111111111110001100111000000000000000000000000000000000000000000000000
00000000011111111111110011101111000000000000000000000000000000000000000000000000
00000000001110011111111111001111000000000000000000000000000000000000000000000000
00000000011110000111111110000111000000000000000000000000000000000000000000000000
00000000111110000111111100000111000000000000000000000000000000000000000000000000
00000011110110001000111101111111100000000000000000000000000000000000000000000000
00000000111111111000111111111111100000000000000000000000000000000000000000000000
00000000100111100000111111000100100000000000000000000000000000000000000000000000
00000000100010000000111111000000000000000000000000000000000000000000000000000000
00000000000110000000011111000000000000000000000000000000000000000000000000000000
00000000001100000000111011000000000000000000000000000000000000000000000000000000
00000000001000111111111111000000000000000000000000000000000000000000000000000000
00000000011000011111111111000000000000000000000000000000000000000000000000000000
00000000011000001111111110000000000000000000000000000000000000000000000000000000
00000000001100000011110010000000000000000000000000000000000000000000000000000000
00000000001100000001100011000000000000000000000000000000000000000000000000000000
00000000001000000001100001100000000000000000000000000000000000000000000000000000
00000000000000000000110001100000000000000000000000000000000000000000000000000000
00000000000000000000100000000000000000000000000000000000000000000000000000000000
00000000000000000000100000000000000000000000000000000000000000000000000000000000
00000000000000000001100000000000000000000000000000000000000000000000000000000000
00000000000000000000100000000000000000000000000000000000000000000000000000000000
00000000000000000000000000000000000000000000000000000000000000000000000000000000
00000000000000000000000000000000000000000000000000000000000000000000000000000000
00000000000000000000000000000000000000000000000000000000000000000000000000000000
00000000000000000000000000000000000000000000000000000000000000000000000000000000
00000000000000000000000000000000000000000000000000000000000000000000000000000000
00000000000000000000000000000000000000000000000000000000000000000000000000000000
00000000000000000000000000000000000000000000000000000000000000000000000000000000
00000000000000000000000000000000000000000000000000000000000000000000000000000000
00000000000000000000000000000000000000000000000000000000000000000000000000000000
00000000000000000000000000000000000000000000000000000000000000000000000000000000
00000000000000000000000000000000000000000000000000000000000000000000000000000000
00000000000000000000000000000000000000000000000000000000000000000000000000000000
00000000000000000000000000000000000000000000000000000000000000000000000000000000
00000000000000000000000000000000000000000000000000000000000000000000000000000000
00000000000000000000000000000000000000000000000000000000000000000000000000000000
00000000000000000000000000000000000000000000000000000000000000000000000000000000
00000000000000000000000000000000000000000000000000000000000000000000000000000000
00000000000000000000000000000000000000000000000000000000000000000000000000000000
00000000000000000000000000000000000000000000000000000000000000000000000000000000
00000000000000000000000000000000000000000000000000000000000000000000000000000000
00000000000000000000000000000000000000000000000000000000000000000000000000000000
00000000000000000000000000000000000000000000000000000000000000000000000000000000
00000000000000000000000000000000000000000000000000000000000000000000000000000000
00000000000000000000000000000000000000000000000000000000000000000000000000000000
00000000000000000000000000000000000000000000000000000000000000000000000000000000
00000000000000000000000000000000000000000000000000000000000000000000000000000000
00000000000000000000000000000000000000000000000000000000000000000000000000000000
00000000000000000000000000000000000000000000000000000000000000000000000000000000
00000000000000000000000000000000000000000000000000000000000000000000000000000000
