80 80
00000000000000000000000000000000000000000000000000000000000000000000000000000000
00000000000000000000000000000000000000000000000000000000000000000000000000000000
00000000000000000000000000000000000000000000000000000000000000000000000000000000
00000000000000000000000000000000000000000000000000000000000000000000000000000000
00000000000000000000000000000000000000000000000000000000000000000000000000000000
00000000000000000000000000000000000000000000000000000000000000000000000000000000
00000000000000000000000000000000000000000000000000000000000000000000000000000000
00000000000000000000000000000000000000000000000000000000000000000000000000000000
00000000000000000000000000000000000000000000000000000000000000000000000000000000
00000000000000000000000000000000000000000000000000000000000000000000000000000000
00000000000000000000000000000000000000000000000000000000000000000000000000000000
00000000000000000000000000000000000000000000000000000000000000000000000000000000
00000000000000000000000000000000000000000000000000000000000000000000000000000000
00000000000000000000000000000000000000000000000000000000000000000000000000000000
00000000000000000000000000000000000000000000000000000000000000000000000000000000
00000000000000000000000000000000000000000000000000000000000000000000000000000000
00000000000000000000000000000000000000000000000000000000000000000000000000000000
00000000000000000000000000000000000000000000000000000000000000000000000000000000
00000000000000000000000000000000000000000000000000000000000000000000000000000000
00000000000000000000000000000000000000000000000000000000000000000000000000000000
00000000000000000000000000000000000000000000000000000000000000000000000000000000
00000000000000000000000000000000000000000000000000000000000000000000000000000000
00000000000000000000000000000000000000000000000000000000000000000000000000000000
00000000000000000000000000000000000000000000000000000000000000000000000000000000
00000000000000000000000000000000000000000000000000000000000000000000000000000000
00000000000000000000000000000000000000000000000000000000000000000000000000000000
00000000000000000000000000000000000000000000000000000000000000000000000000000000
00000000000000000000000000000000000000000000000000000000000000000000000000000000
00000000000000000000000000000000000000000000000000000000000000000000000000000000
00000000000000000000000000000000000000000000000000000000000000000000000000000000
00000000000000000000000000000000000000000000000000000000000000000000000000000000
00000000000000000000000000000000000000000000000000000000000000000000000000000000
00000000000000000000000000000000000000000000000000000000000000000000000000000000
00000000000000000000000000000000000000000000000000000000000000000000000000000000
00000000000000000000000000000000000000000000000000000000000000000000000000000000
00000000000000000000000000000000000000000000000000000000000000000000000000000000
00000000000000000000000000000000000000000000000000000000000000000000000000000000
00000000000000000000000000000000000000000000000000000000000000000000000000000000
00000000000000000000000000000000000000000000000110001100000000000000000000000000
00000000000000000000000000000000000000000000001110011000000000000000000000000000
00000000000000000000000000000000000000000011111011110000000000000000000000000000
00000000000000000000000000000000000000000000100001100000000000000000000000000000
00000000000000000000000000000000000000000000100001100000000000000000000000000000
00000000000000000000000000000000000000000000100011100000000000000000000000000000
00000000000000000000000000000000000000000000011111100000000000000000000000000000
00000000000000000000000000000000000000000000011111110000000000000000000000000000
00000000000000000000000000000000000000000000111211100000000000000000000000000000
00000000000000000000000000000000000000000000111111000000000000000000000000000000
00000000000000000000000000000000000000000000110001000000000000000000000000000000
00000000000000000000000000000000000000001000110001100000000000000000000000000000
00000000000000000000000000000000000000001000010001110000000000000000000000000000
00000000000000000000000000000000000000011000011000110000000000000000000000000000
00000000000000000000000000000000000000011000001000010000000000000000000000000000
00000000000000000000000000000000000000011110000000011111000000000000000000000000
00000000000000000000000000000000000000011111001100111111000000000000000000000000
00000000000000000000000000000000000000011101111001111111000000000000000000000000
00000000000000000000000000000000000011111100011001110111000000000000000000000000
00000000000000000000000000000000000000010000111111100000000000000000000000000000
00000000000000000000000000000000000000000000111111000000011000000000000000000000
00000000000000000000000000000000000000000001111111100001111100000000000000000000
00000000000000000000000000000000000000000000111111110001000111000000000000000000
00000000000000000000000000000000000000000000011000111011000001101000000000000000
00000000000000000000000000000000000000000011111000011011110000111000000000000000
00000000000000000000000000000000000000000000111000011111100000111100100000000000
00000000000000000000000000000000000000000000011000110111000000001111110000010000
00000000000000000000000000000000000000000000111000110111100000001111111000010000
00000000000000000000000000000000000000000000100000111101100000011111000000010000
00000000000000000000000000000000000000000000000001111100000000001111000000010000
00000000000000000000000000000000000000000000000011111110000000001111000001110000
00000000000000000000000000000000000000000000000000111011000000001110100001111000
00000000000000000000000000000000000000000000000000110001000000001110111111111000
00000000000000000000000000000000000000000000000001100001000000000110000001111000
00000000000000000000000000000000000000000000000001000001100000000111000000011000
00000000000000000000000000000000000000000000000000000001111000000011100000111000
00000000000000000000000000000000000000000000000000000001111110000000110000111000
00000000000000000000000000000000000000000000000000000001011110000000011100111000
00000000000000000000000000000000000000000000000000000011001110000000001110111100
00000000000000000000000000000000000000000000000000000110000011000000000011100110
00000000000000000000000000000000000000000000000000000000000001000000000011000000
00000000000000000000000000000000000000000000000000000000000000000000000000000000
