80 80
00000000000000000000000000000000000000000000000000000000000000000000000000000000
00000000000000000000000000000000000000000000000000000000000000000000000000000000
00000000000000000000000000000000000000000000000000000000000000000000000000000000
00000000000000000000000000000000000000000000000000000000000000000000000000000000
00000000000000000000000000000000000000000000000000000000000000000000000000000000
00000000000000000000000000000000000000000000000000000000000000000000000000000000
00000000000000000000000000000000000000000000000000000000000000000000000000000000
00000000000000000000000000000000000000000000000000000000000000000000000000000000
00000000000000000000000000000000000000000000000000011000000000100000000000001000
00000000000000000000000000000000001110001000000000110000000001111100011100011000
00000000000000000000000000000000001110001000000000100000000111111111111110110000
00000000000000000000000000000000011100001000000001100000000100111111111111110000
00000000000000000000000000000000001100001100000001101100000000111111000011110000
00000000000000000000000000000000000100001111100001111000011111111110000111111110
00000000000000000000000000000000000101101111110001110001111111001110001111111110
00000000000000000000000000000000000111111111110001110011111111111110011111111110
00000000000000000000000000000000000111111011111011110111111111111110011111111110
00000000000000000000000000000000000011100111111111111100011111111111111111111110
00000000000000000000000000000000000000110001110000111100111111111111111111110010
00000000000000000000000000000001111001111111110000111111111111111111011101111000
00000000000000000000000000000011111111011111110000111111111111111111011100111000
00000000000000000000000000000110000011011110011001111111111111111111011000111100
00000000000000000000000000000010000000111110000111111111211111111111011000011100
00000000000000000000000000000000000001110000000011111111111111001111011000011000
00000000000000000000000000000000000011110001100011111111111110001111011100011000
00000000000000000000000000000000000111111111111111111111111111111110011100111000
00000000000000000000000000000000001101000110001111111111111111111110011000111000
00000000000000000000000000000000000111000110000011100111111111111111111000111000
00000000000000000000000000000000000000001110000001000111000011111111111000110000
00000000000000000000000000000000000000011011000001110011000011101110111100010000
00000000000000000000000000000000000000001100000001110011100111001110111100010000
00000000000000000000000000000000000000000000000001110001101110000111111110110000
00000000000000000000000000000000000000000000000000000011111000000000001111100000
00000000000000000000000000000000000000000000000000100111100000000000001101100000
00000000000000000000000000000000000000000000010000111111000000000000001000100000
00000000000000000000000000000000000000000000010011111111100000000000001000111000
00000000000000000000000000000000000000000000011011010011100000000000001000001110
00000000000000000000000000000000000000000000001110000111000000000000001100000110
00000000000000000000000000000000000000000000000010000100000000000000001100000010
00000000000000000000000000000000000000000000000000000100100000000000001100000000
00000000000000000000000000000000000000000000000000110111110000000000001000000000
00000000000000000000000000000000000000000000000000011110000000000000011000000000
00000000000000000000000000000000000000000000000000011000000000000000000000000000
00000000000000000000000000000000000000000000000000011000000000000000000000000000
00000000000000000000000000000000000000000000000000111100000000000000000000000000
00000000000000000000000000000000000000000000000000100111000000000000000000000000
00000000000000000000000000000000000000000000000000000000000000000000000000000000
00000000000000000000000000000000000000000000000000000000000000000000000000000000
00000000000000000000000000000000000000000000000000000000000000000000000000000000
00000000000000000000000000000000000000000000000000000000000000000000000000000000
00000000000000000000000000000000000000000000000000000000000000000000000000000000
00000000000000000000000000000000000000000000000000000000000000000000000000000000
00000000000000000000000000000000000000000000000000000000000000000000000000000000
00000000000000000000000000000000000000000000000000000000000000000000000000000000
00000000000000000000000000000000000000000000000000000000000000000000000000000000
00000000000000000000000000000000000000000000000000000000000000000000000000000000
00000000000000000000000000000000000000000000000000000000000000000000000000000000
00000000000000000000000000000000000000000000000000000000000000000000000000000000
00000000000000000000000000000000000000000000000000000000000000000000000000000000
00000000000000000000000000000000000000000000000000000000000000000000000000000000
00000000000000000000000000000000000000000000000000000000000000000000000000000000
00000000000000000000000000000000000000000000000000000000000000000000000000000000
00000000000000000000000000000000000000000000000000000000000000000000000000000000
00000000000000000000000000000000000000000000000000000000000000000000000000000000
00000000000000000000000000000000000000000000000000000000000000000000000000000000
00000000000000000000000000000000000000000000000000000000000000000000000000000000
00000000000000000000000000000000000000000000000000000000000000000000000000000000
00000000000000000000000000000000000000000000000000000000000000000000000000000000
00000000000000000000000000000000000000000000000000000000000000000000000000000000
00000000000000000000000000000000000000000000000000000000000000000000000000000000
00000000000000000000000000000000000000000000000000000000000000000000000000000000
00000000000000000000000000000000000000000000000000000000000000000000000000000000
00000000000000000000000000000000000000000000000000000000000000000000000000000000
00000000000000000000000000000000000000000000000000000000000000000000000000000000
00000000000000000000000000000000000000000000000000000000000000000000000000000000
00000000000000000000000000000000000000000000000000000000000000000000000000000000
00000000000000000000000000000000000000000000000000000000000000000000000000000000
00000000000000000000000000000000000000000000000000000000000000000000000000000000
00000000000000000000000000000000000000000000000000000000000000000000000000000000
00000000000000000000000000000000000000000000000000000000000000000000000000000000
