80 80
00000000000000000000000000000000000000000000000000000000000000000000000000000000
01011100000000000000000000000000000000000000000000000000000000000000000000000000
01111100000000000000000000000000000000000000000000000000000000000000000000000000
01111100000000000000000000000000000000000000000000000000000000000000000000000000
01111100000000000000000000000000000000000000000000000000000000000000000000000000
01111110000000000000000000000000000000000000000000000000000000000000000000000000
01000110001000000000000000000000000000000000000000000000000000000000000000000000
01011111001100000000000000000000000000000000000000000000000000000000000000000000
01101111101100000000000000000000000000000000000000000000000000000000000000000000
01000110111100000000000000000000000000000000000000000000000000000000000000000000
00000100011100000000000000000000000000000000000000000000000000000000000000000000
01001100011100000000000000000000000000000000000000000000000000000000000000000000
01001110000000000000000000000000000000000000000000000000000000000000000000000000
01111111100000000000000000000000000000000000000000000000000000000000000000000000
01111111110000000000000000000000000000000000000000000000000000000000000000000000
01111111111100000000000000000000000000000000000000000000000000000000000000000000
01111110000110000000000000000000000000000000000000000000000000000000000000000000
01111110000000000000000000000000000000000000000000000000000000000000000000000000
01100100000000000000000000000000000000000000000000000000000000000000000000000000
01000100111000000000000000000000000000000000000000000000000000000000000000000000
01111110011111000000000000000000000000000000000000000000000000000000000000000000
01111100001111100000000000000000000000000000000000000000000000000000000000000000
01110000001111110000000000000000000000000000000000000000000000000000000000000000
01100000011111111000000000000000000000000000000000000000000000000000000000000000
01110010111111110000000000000000000000000000000000000000000000000000000000000000
00011111111111111000000000000000000000000000000000000000000000000000000000000000
00000001111110011101100000000000000000000000000000000000000000000000000000000000
00000000111111011111100000000000000000000000000000000000000000000000000000000000
00000000000111111111100000000000000000000000000000000000000000000000000000000000
00000000001111111111100000000000000000000000000000000000000000000000000000000000
00000000111111111101100000000000000000000000000000000000000000000000000000000000
00000000111111111001100000000000000000000000000000000000000000000000000000000000
00000000000111000001000000000000000000000000000000000000000000000000000000000000
00000000001110000010000000000000000000000000000000000000000000000000000000000000
00000000001100111110000000000000000000000000000000000000000000000000000000000000
00000000001101111100000000000000000000000000000000000000000000000000000000000000
00000000011111111100000000000000000000000000000000000000000000000000000000000000
00000000111111111100000000000000000000000000000000000000000000000000000000000000
00000011111111111100000000000000000000000000000000000000000000000000000000000000
00000111111111111100000000000000000000000000000000000000000000000000000000000000
00001111111111111110000000000000000000000000000000000000000000000000000000000000
00011111111111111110000000000000000000000000000000000000000000000000000000000000
01111111111111111111000000000000000000000000000000000000000000000000000000000000
01111111111111111111000000000000000000000000000000000000000000000000000000000000
01111111111111111111100000000000000000000000000000000000000000000000000000000000
01111111111111111111110111100000000000000000000000000000000000000000000000000000
01111111111111111111111111100000000000000000000000000000000000000000000000000000
01111111111111111111001111100000000000000000000000000000000000000000000000000000
01111111111111111111101100000000000000000000000000000000000000000000000000000000
01111111111111111111100000000000000000000000000000000000000000000000000000000000
01111111111111111111100000000000000000000000000000000000000000000000000000000000
01111111111111111111100000000000000000000000000000000000000000000000000000000000
01111111111111111111100000000000000000000000000000000000000000000000000000000000
01111111111111111111100000000000000000000000000000000000000000000000000000000000
01111111111111111111100000000000000000000000000000000000000000000000000000000000
01111111111111111111100000000000000000000000000000000000000000000000000000000000
01111111111111111111100000000111000000000000000000000000000000000000000000000000
01111111111111111111100000011111100000000000000000000000000000000000000000000000
01111111111111111111000001111111000000000000000000000000000000000000000000000000
01111111111111111111000111111110000000000000000000000000000000000000000000000000
01111111111111111111011111211110000000000000000000000000000000000000000000000000
01111100001111111111111111111100000000000000000000000000000000000000000000000000
00000000000001111111111111111000000000000000000000000000000000000000000000000000
00000000000000011110000000110000000000000000000000000000000000000000000000000000
00000000000000000000000000000000000000000000000000000000000000000000000000000000
00000000000000000000000000000000000000000000000000000000000000000000000000000000
00000000000000000000000000000000000000000000000000000000000000000000000000000000
00000000000000000000000000000000000000000000000000000000000000000000000000000000
00000000000000000000000000000000000000000000000000000000000000000000000000000000
00000000000000000000000000000000000000000000000000000000000000000000000000000000
00000000000000000000000000000000000000000000000000000000000000000000000000000000
00000000000000000000000000000000000000000000000000000000000000000000000000000000
00000000000000000000000000000000000000000000000000000000000000000000000000000000
00000000000000000000000000000000000000000000000000000000000000000000000000000000
00000000000000000000000000000000000000000000000000000000000000000000000000000000
00000000000000000000000000000000000000000000000000000000000000000000000000000000
00000000000000000000000000000000000000000000000000000000000000000000000000000000
00000000000000000000000000000000000000000000000000000000000000000000000000000000
00000000000000000000000000000000000000000000000000000000000000000000000000000000
00000000000000000000000000000000000000000000000000000000000000000000000000000000
