80 80
00000000000000000000000000000000000000000000000000000000000000000000000000000000
00000000000000000000000000000000000000000000000000000000000000000000000000000000
00000000000000000000000000000000000000000000000000000000000000000000000000000000
00000000000000000000000000000000000000000000000000000000000000000000000000000000
00000000000000000000000000000000000000000000000000000000000000000000000000000000
00000000000000000000000000000000000000000000000000000000000000000000000000000000
00000000000000000000000000000000000000000000000000000000000000000000000000000000
00000000000000000000000000000000000000000000000000000000000000000000000000000000
00000000000000000000000000000000000000000000000000000000000000000000000000000000
00000000000000000000000000000000000000000000000000000000000000000000000000000000
00000000000000000000000000000000000000000000000000000000000000000000000000000000
00000000000000000000000000000000000000000000000000000000000000000000000000000000
00000000000000000000000000000000000000000000000000000000000000000000000000000000
00000000000000000000000000000000000000000000000000000000000000000000000000000000
00000000000000000000000000000000000000000000000000000000000000000000000000000000
00000000000000000000000000000000000000000000000000000000000000000000000000000000
00000000000000000000000000000000000000000000000000000000000000000000000000000000
00000000000000000000000000000000000000000000000000000000000000000000000000000000
00000000000000000000000000000000000000000000000000000000000000000000000000000000
00000000000000000000000000000000000000000000000000000000000000000000000000000000
00000000000000000000000000000000000000000000000000000000000000000000000000000000
00000000000000000000000000000000000000000000000000000000000000000000000000000000
00000000000000000000000000000000000000000000000000000000000000000000000000000000
00000000000000000000000000000000000000000000000000000000000000000000000000000000
00000000000000000000000000000000000000000000000000000000000000000000000000000000
00000000000000000000000000000000000000000000000000000000000000000000000000000000
00000000000000000000000000000000000000000000000000000000000000000000000000000000
00000000000000000000000000000000000000000000000000000000000000000000000000000000
00000000000000000000000000000000000000000000000000000000000000000000000000000000
00000000000000000000000000000000000000000000000000000000000000000000000000000000
00000000000000000000000000000000000000000000000000000000000000000000000000000000
00000000000000000000000000000000000000000000000000000000000000000000000000000000
00000000000000000000000000000000000000000000000000000000000000000000000000000000
00000000000000000000000000000000000000000000000000000000000000000000000000000000
00000000000000000000000000000000000000000000000000000000000000000000000000000000
00000000000000000000000000000000000000000000000000000000000000000000000000000000
00000000000000000000000000000000000000000000000000000000000000000000000000000000
00000000000000000000000000000000000000000000000000000000000000000000000000000000
00000000000000000000000000000000000000000000000000000000000000000000000000000000
00000000000000000000000000000000000000000000000000000100000000000000000000000000
00000000000000000000000000000000000000000000000000000111110000000000000000000000
00000000000000000000000000000000000000000000000000000111100000000000000000000000
00000000000000000000000000000000000000000000000000000111100000000001000000000000
00000000000000000000000000000000000000000000000000000111100000000001000000000000
00000000000000000000000000000000000000000000000000001101100001000011000000000000
00000000000000000000000000000000000000000000000001111011000111111111111100000000
00000000000000000000000000000000000000000000000000000011001100111100000000000000
00000000000000000000000000000000000000000000000000111110000000111111000000000000
00000000000000000000000000000000000000000000000001101110000001111110000000000000
00000000000000000000000000000000000000000000000011000011000011101111001100000000
00000000000000000000000000000000000000000000000001110001000011011111111100000000
00000000000000000000000000000000000000000000000000000001100110011001111000000000
00000000000000000000000000000000000000000000000000000000111110110000000000000000
00000000000000000000000000000000000000000000000000000000011110110000000000000000
00000000000000000000000000000000000000000000000000000001111111111011111100000000
00000000000000000000000000000000000000000000000000000011111111011111111100000000
00000000000000000000000000000000000000000000000000001111111110001111111100000000
00000000000000000000000000000000000000000000000000001111111110001100111110000000
00000000000000000000000000000000000000000000000000001111111110011000001110000000
00000000000000000000000000000000000000000000000000000011111111111100001111001110
00000000000000000000000000000000000000000000000000000011111111111110011111111110
00000000000000000000000000000000000000000000000000000111111111100110001001110010
00000000000000000000000000000000000000000000000000000111110011100000000001100010
00000000000000000000000000000000000000000000000000000001111011110000100001110110
00000000000000000000000000000000000000000000000000000001100111001101101100110010
00000000000000000000000000000000000000000000000000000011100111001111111100110000
00000000000000000000000000000000000000000000000000000011000111000111011000010000
00000000000000000000000000000000000000000000000000000010011111000001110010000000
00000000000000000000000000000000000000000000001110000100111111100001110010000000
00000000000000000000000000000000000000000000011111101101100011110111111111100000
00000000000000000000000000000000000000000000011111111111000111011111211111111000
00000000000000000000000000000000000000000000110011111111000010001111111110000000
00000000000000000000000000000000000000000000110011111111000000001111111100000000
00000000000000000000000000000000000000000001110011111111000001011110011000000000
00000000000000000000000000000000000000000000110001111111000111111100001000000000
00000000000000000000000000000000000000000000011111111111100111001110001000000000
00000000000000000000000000000000000000000000001110110001100111000010001000000000
00000000000000000000000000000000000000000000000100011001101000000000001000000000
00000000000000000000000000000000000000000000001100011111111000000000011000000000
00000000000000000000000000000000000000000000000000000000000000000000000000000000
