80 80
00000000000000000000000000000000000000000000000000000000000000000000000000000000
00000000000000000000000000000000000000000000000000000000000000000000000000000000
00000000000000000000000000000000000000000000000000000000000000000000000000000000
00000000000000000000000000000000000000000000000000000000000000000000000000000000
00000000000000000000000000000000000000000000000000000000000000000000000000000000
00000000000000000000000000000000000000000000000000000000000000000000000000000000
00000000000000000000000000000000000000000000000000000000000000000000000000000000
00000000000000000000000000000000000000000000000000000000000000000000000000000000
00000000000000000000000000000000000000000000000000000000000000000000000000000000
00000000000000000000000000000000000000000000000001000001000000000000000000000000
00000000000000000000000000000000000000000000000001100001000011000000000000000000
00000000000000000000000000000000000000000000000000110001100010000000000000000000
00000000000000000000000000000000000000000000000001110001111110000000000000000000
00000000000000000000000000000000000000000000000001100011111110000000000000000000
00000000000000000000000000000000000000000111000011100111111111000000000000000000
00000000000000000000000000000000000000011111111101111111111111000000000000000000
00000000000000000000000000000000000011111000011100011111111110000000000000000000
00000000000000000000000000000000000000110000000000000001001110000000000000000000
00000000000000000000000000000000000000110001100000001011011111000000000000000000
00000000000000000000000000000000000000111011110010111111111111000000000000000000
00000000000000000000000000000000001111111111111011111111111111001111111000000000
00000000000000000000000000000000000000001110011011111111111110000111101110000000
00000000000000000000000000000000000000000100001111111000111100001100100110000000
00000000000000000000000000000000000000000110000111110000011101111111111110000000
00000000000000000000000000000000000000001111100111100000111111100111101000000000
00000000000000000000000000000000000000111101111111111111111111001111111000000000
00000000000000000000000000000000000000111000001100111111111111001100011000000000
00000000000000000000000000000000000000111100000011111112111110011000010000000000
00000000000000000000000000000000000000011000000111111111111100011111110000000000
00000000000000000000000000000000000000001000011111111111110110111100011000000000
00000000000000000000000000000000000000001000011111110111100111111100011100000000
00000000000000000000000000000000000000000000110111100011000011110110001100000000
00000000000000000000000000000000000000000001111111110001000001100010000000000000
00000000000000000000000000000000000000000011111000110001000001100000000000000000
00000000000000000000000000000000000000000000010000111111100011000000000000000000
00000000000000000000000000000000000000000000010000111111111110000000000000000000
00000000000000000000000000000000000000000000010001100011110110000000000000000000
00000000000000000000000000000000000000000000000011101111110100000000000000000000
00000000000000000000000000000000000000000000000000111111111110000000000000000000
00000000000000000000000000000000000000000000000000100111111110000000000000000000
00000000000000000000000000000000000000000000000000100111110110011110000000000000
00000000000000000000000000000000000000000000000000100111100011110011000100000000
00000000000000000000000000000000000000000000000000001100000001100001100100000000
00000000000000000000000000000000000000000000000000001000000000000000111110000000
00000000000000000000000000000000000000000000000000000000000000001100001011000000
00000000000000000000000000000000000000000000000000000000000000000111111100000000
00000000000000000000000000000000000000000000000000000000000000000111101000000000
00000000000000000000000000000000000000000000000000000000000000000001111100000000
00000000000000000000000000000000000000000000000000000000000000000000111110000000
00000000000000000000000000000000000000000000000000000000000001111001111110000000
00000000000000000000000000000000000000000000000000000011111111001111111110010000
00000000000000000000000000000000000000000000000000000000001000000011001100110000
00000000000000000000000000000000000000000000000000000000000000000000001111110000
00000000000000000000000000000000000000000000000000000000000000000000011111110000
00000000000000000000000000000000000000000000000000000000000000000000011111011000
00000000000000000000000000000000000000000000000000000000000000000000011111110000
00000000000000000000000000000000000000000000000000000000000000000000000001110000
00000000000000000000000000000000000000000000000000000000000000000000000001100000
00000000000000000000000000000000000000000000000000000000000000000000000001110000
00000000000000000000000000000000000000000000000000000000000000000000000000111000
00000000000000000000000000000000000000000000000000000000000000000000000001111000
00000000000000000000000000000000000000000000000000000000000000000000000000111000
00000000000000000000000000000000000000000000000000000000000000000000000000000000
00000000000000000000000000000000000000000000000000000000000000000000000000000000
00000000000000000000000000000000000000000000000000000000000000000000000000000000
00000000000000000000000000000000000000000000000000000000000000000000000000000000
00000000000000000000000000000000000000000000000000000000000000000000000000000000
00000000000000000000000000000000000000000000000000000000000000000000000000000000
00000000000000000000000000000000000000000000000000000000000000000000000000000000
00000000000000000000000000000000000000000000000000000000000000000000000000000000
00000000000000000000000000000000000000000000000000000000000000000000000000000000
00000000000000000000000000000000000000000000000000000000000000000000000000000000
00000000000000000000000000000000000000000000000000000000000000000000000000000000
00000000000000000000000000000000000000000000000000000000000000000000000000000000
00000000000000000000000000000000000000000000000000000000000000000000000000000000
00000000000000000000000000000000000000000000000000000000000000000000000000000000
00000000000000000000000000000000000000000000000000000000000000000000000000000000
00000000000000000000000000000000000000000000000000000000000000000000000000000000
00000000000000000000000000000000000000000000000000000000000000000000000000000000
00000000000000000000000000000000000000000000000000000000000000000000000000000000
