80 80
00000000000000000000000000000000000000000000000000000000000000000000000000000000
00000000000000000000000000000000000000000000000000000000000000000000000000000000
00000000000000000000000000000000000000000000000000000000000000000000000000000000
00000000000000000000000000000000000000000000000000000000000000000000000000000000
00000000000000000000000000000000000000000000000000000000000000000000000000000000
00000000000000000000000000000000000000000000000000000000000000000000000000000000
00000000000000000000000000000000000000000000000000000000000000000000000000000000
00000000000000000000000000000000000000000000000000000000000000000000000000000000
00000000000000000000000000000000000000000000000000000000000000000000000000000000
00000000000000000000000000000000000000000000000000000000000000000000000000000000
00000000000000000000000000000000000000000000000000000000000000000000000000000000
00000000000000000000000000000000000000000000000000000000000000000000000000000000
00000000000000000000000000000000000000000000000000000000000000000000000000000000
00000000000000000000000000000000000000000000000000000000000000000000000000000000
00000000000000000000000000000000000000000000000000000000000000000000000000000000
00000000000000000000000000000000000000000000000000000000000000000000000000000000
00000000000000000000000000000000000000000000000000000000000000000000000000000000
00000000000000000000000000000000000000000000000000000000000000000000000000000000
00000000000000000000000000000000000000000000000000000000000000000000000000000000
00000000000000000000000000000000000000000000000000000000000000000000000000000000
00000000000000000000000000000000000000000000000000000000000000000000000000000000
00000000000000000000000000000000000000000000000000000000000000000000000000000000
00000000000000000000000000000000000000000000000000000000000000000000000000000000
00000000000000000000000000000000000000000000000000000000000000000000000000000000
00000000000000000000000000000000000000000000000000000000000000000000000000000000
00000000000000000000000000000000000000000000000000000000000000000000000000000000
00000000000000000000000000000000000000000000000000000000000000000000000000000000
00000000000000000000000000000000000000000000000000000000000000000000000000000000
00000000000000000000000000000000000000000000000000000000000000000000000000000000
00000000000000000000000000000000000000000000000000000000000000000000000000000000
00000000000000000000000000000000000000000000000000000000000000000000000000000000
00000000000000000000000000000000000000000000000000000000000000000000000000000000
00000000000000000000000000000000000000000000000000000000000000000000000000000000
00000000000000000000000000000000000000000000000000000000000000000000000000000000
00000000000000000000000000000000000000000000000000000000000000000000000000000000
00000000000000000000000000000000000000000000000000000000000000000000000000000000
00000000000000000000000000000000000000000000000000000000000000000000000000000000
00000000000000000000000000000000000000000000000000000000000000000000000000000000
00000000000000000000000000000000000000000000000000000000000000000000000000000000
00000000000000000000000000000000000000000000000000000000000000000000000000000000
00000000000000000000000000000000000000000000000000000001000000000000000000000000
00000000000000000000000000000000000000000000000000000001000000000000000000000000
00000000000000000000000000000000000000000000000000000001100000000000000000000000
00000000000000000000000000000000000000000000000011000001110000000000000000000000
00000000000000000000000000000000000000000000000111100111010011000000000000000000
00000000000000000000000000000000000000000000111100111111111010000000000000000000
00000000000000000000000000000000000000000000000000111000111110000000000000000000
00000000000000000000000000000000000000000000000000111000001100000000000000000000
00000000000000000000000000000000000000000000000001111000000100000000000000000000
00000000000000000000000000000000000000001001100001111110000110000000000000000000
00000000000000000000000000000000000000011111111001110111100111000000000000000000
00000000000000000000000000000000000000001011001000111001110011000000000000000000
00000000000000000000000000000000000000000011000000011100111011100000000000000000
00000000000000000000000000000000000000000011000000001001111111100000000000000000
00000000000000000000000000000000010000000111110110001001100111100000000000000000
00000000000000000000000000000111111111111110111111111111000111100000000000000000
00000000000000000000000000000000100000110000011110001111000111000000000000000000
00000000000000000000000000000000100000000000000100001111000011000000000000000000
00000000000000000000000000000000000000000000000100001000000000000000000000000000
00000000000000000000000000000000000000011000110110110000000000000000000000000000
00000000000000000000000000000000000000001000011111100000000000000000000000000000
00000000000000000000000000000000000000001100011111100000000000000000000000000000
00000000000000000000000000000000000000001100011111000000000000000000000000000000
00000000000000000000000000000000000000011001111011000000000000000000000000000000
00000000000000000000000000000000000000001000111001100000000000000000000000000000
00000000000000000000000000000000001110001000011000100000000000000000000000000000
00000000000000000000000000000000000111001000110000110000000000000000000000000000
00000000000000000000000000000000000111011000110000000000000000000000000000000000
00000000000000000000000000000000001111011101110000000000000000000000000000000000
00000000000000000000000000000000001110001111110000000000000000000000000000000000
00000000000000000000000000000000011111001111110000000000000000000000000000000000
00000000000000000000000000000000000001111011010000000000000000000000000000000000
00000000000000000000000000000000000000100011001000000000000000000000000000000000
00000000000000000000000000000000000000100011011000000111110000000000000000000000
00000000000000000000000000000000000000111111111100111111110000000000000000000000
00000000000000000000000000000000000000011111111111110011100000000000000000000000
00000000000000000000000000000000000000001111111111100011100000000000000000000000
00000000000000000000000000000000000000000000112110000001000000000000000000000000
00000000000000000000000000000000000000000000111110000000000000000000000000000000
00000000000000000000000000000000000000000000000000000000000000000000000000000000
