80 80
00000000000000000000000000000000000000000000000000000000000000000000000000000000
00000000000000000000000000000000000000000111111100100000000000000000000000000000
00000000000000000000000000000000000000000011111100100000000000000000000000000000
00000000000000000000000000000000000000000001111100110000000000000000000000000000
00000000000000000000000000000000000000100001111100110000000000000000000000000000
00000000000000000011111000000000000000111100111111110000000000000000000000000000
00000000000000000011011100000000000000100000111100100000000000000000000000000000
00011000000000000010011100000000000001100000111100000000000000000000000000000000
01111110000000000111111110000001000011110001110000000000000000000000000000000000
01100110000011111111100010001001100111001011110000000000000000000000000000000000
01001110011111111111110011111111111111001011010000000000000000000000000000000000
00001111110001111000110000111100010110011010011000000000000000000000000000000000
00001111000000000000011000000000000000001110001000000000000000000000000000000000
00011110001100001100001000000000000001000110000000000000000000000000000000000000
00011100001100011100011111110011000111101111100000000000000000000000000000000000
00111100001001111011111011110111101110111111111100000000000000000000000000000000
00000110001101110011100011111110011100010000001100000000000000000000000000000000
00000000000111111000000011111100111100000000000000000000000000000000000000000000
00000001000011111000100001111111100110000000000000000000000000000000000000000000
00001111101111111001111111111111100110000000000000000000000000000000000000000000
00000111111111111001111111111111111100000000000000000000000000000000000000000000
00000011111111111011111211111110111100000000000000000000000000000000000000000000
00000000111111110111111111010000011000000000000000000000000000000000000000000000
00010000011111100011111111100000001000000000000000000000000000000000000000000000
00111000001111110111111111100001111111000000000000000000000000000000000000000000
01111110011111111111111111100111001110000000000000000000000000000000000000000000
01100011111111111111100111111110001110000000000000000000000000000000000000000000
00110001111111111110000011111000001110000000000000000000000000000000000000000000
00010000111111111110000001111000001100000000000000000000000000000000000000000000
00001000011011111111110001111111111100000000000000000000000000000000000000000000
00001110011110111011111111111111111110000000000000000000000000000000000000000000
00000110001111110001111111011111110110000000000000000000000000000000000000000000
00001110000111110000111110000100111100000000000000000000000000000000000000000000
01011100000011110000111110000000111000000000000000000000000000000000000000000000
01111110001111110000110011000001111100000000000000000000000000000000000000000000
01011111111111110000100011100111101100000000000000000000000000000000000000000000
01001111111111111000100001111100000000000000000000000000000000000000000000000000
00011111111111111000000001111000000000000000000000000000000000000000000000000000
00111110001111110000000001111100000000000000000000000000000000000000000000000000
00011100001111110001111001100110000000000000000000000000000000000000000000000000
00001110011100111011110001000110000000000000000000000000000000000000000000000000
00000000111000011111110011000011000000000000000000000000000000000000000000000000
00000000110000111111110110000011000000000000000000000000000000000000000000000000
00000001111000110001110010000010000000000000000000000000000000000000000000000000
00000011001000110001110000000010000000000000000000000000000000000000000000000000
00011110001000111001110000000010000000000000000000000000000000000000000000000000
00000000001000001001110000000010000000000000000000000000000000000000000000000000
00000000000000000000000000000000000000000000000000000000000000000000000000000000
00000000000000000000000000000000000000000000000000000000000000000000000000000000
00000000000000000000000000000000000000000000000000000000000000000000000000000000
00000000000000000000000000000000000000000000000000000000000000000000000000000000
00000000000000000000000000000000000000000000000000000000000000000000000000000000
00000000000000000000000000000000000000000000000000000000000000000000000000000000
00000000000000000000000000000000000000000000000000000000000000000000000000000000
00000000000000000000000000000000000000000000000000000000000000000000000000000000
00000000000000000000000000000000000000000000000000000000000000000000000000000000
00000000000000000000000000000000000000000000000000000000000000000000000000000000
00000000000000000000000000000000000000000000000000000000000000000000000000000000
00000000000000000000000000000000000000000000000000000000000000000000000000000000
00000000000000000000000000000000000000000000000000000000000000000000000000000000
00000000000000000000000000000000000000000000000000000000000000000000000000000000
00000000000000000000000000000000000000000000000000000000000000000000000000000000
00000000000000000000000000000000000000000000000000000000000000000000000000000000
00000000000000000000000000000000000000000000000000000000000000000000000000000000
00000000000000000000000000000000000000000000000000000000000000000000000000000000
00000000000000000000000000000000000000000000000000000000000000000000000000000000
00000000000000000000000000000000000000000000000000000000000000000000000000000000
00000000000000000000000000000000000000000000000000000000000000000000000000000000
00000000000000000000000000000000000000000000000000000000000000000000000000000000
00000000000000000000000000000000000000000000000000000000000000000000000000000000
00000000000000000000000000000000000000000000000000000000000000000000000000000000
00000000000000000000000000000000000000000000000000000000000000000000000000000000
00000000000000000000000000000000000000000000000000000000000000000000000000000000
00000000000000000000000000000000000000000000000000000000000000000000000000000000
00000000000000000000000000000000000000000000000000000000000000000000000000000000
00000000000000000000000000000000000000000000000000000000000000000000000000000000
00000000000000000000000000000000000000000000000000000000000000000000000000000000
00000000000000000000000000000000000000000000000000000000000000000000000000000000
00000000000000000000000000000000000000000000000000000000000000000000000000000000
00000000000000000000000000000000000000000000000000000000000000000000000000000000
