80 80
00000000000000000000000000000000000000000000000000000000000000000000000000000000
00000000000000000000000000000000000000000000000000000000000000000000000000000000
00000000000000000000000000000000000000000000000000000000000000000000000000000000
00000000000000000000000000000000000000000000000000000000000000000000000000000000
00000000000000000000000000000000000000000000000000000000000000000000000000000000
00000000000000000000000000000000000000000000000000000000000000000000000000000000
00000000000000000000000000000000000000000000000000000000000000000000000000000000
00000000000000000000000000000000000000000000000000000000000000000000000000000000
00000000000000000000000000000000000000000000000000000000000000000000000000000000
00000000000000000000000000000000000000000000000000000000000000000000000000000000
00000000000000000000000000000000000000000000000000000000000000000000000000000000
00000000000000000000000000000000000000000000000000000000000000000000000000000000
00000000000000000000000000000000000000000000000000000000000000000000000000000000
00000000000000000000000000000000000000000000000000000000000000000000000000000000
00000000000000000000000000000000000000000000000000000000000000000000000000000000
00000000000000000000000000000000000000000000000000000000000000000000000000000000
00000000000000000000000000000000000000000000000000000000000000000000000000000000
00000000000000000000000000000000000000000000000000000000000000000000000000000000
00000000000000000000000000000000000000000000000000000000000000000000000000000000
00000000000000000000000000000000000000000000000000000000000000000000000000000000
00000000000000000000000000000000000000000000000000000000000000000000000000000000
00000000000000000000000000000000000000000000000000000000000000000000000000000000
00000000000000000000000000000000000000000000000000000000000000000000000000000000
00000000000000000000000000000000000000000000000000000000000000000000000000000000
00000000000000000000000000000000000000000000000000000000000000000000000000000000
00000000000000000000000000000000000000000000000000000000000000000000000000000000
00000000000000000000000000000000000000000000000000000000000000000000000000000000
00000000000000000000000000000000000000000000000000000000000000000000000000000000
00000000000000000000000000000000000000000000000000000000000000000000000000000000
00000000000000000000000000000000000000000000000000000000000000000000000000000000
00000000000000000000000000000000000000000000000000000000000000000000000000000000
00000000000000000000000000000000000000000000000000000000000000000000000000000000
00000000000000000000000000000000000000000000000000000000000000000000000000000000
00000000000000000000000000000000000000000000000000000000000000000000000000000000
00000000000000000000000000000000000000000000000000000000000000000000000000000000
00000000000000000000000000000000000000000000000000000000000000000000000000000000
00000000000000000000000000000000000000000000000000000000000000000000000000000000
00000000000000000000000000000000000000000000000000000000000000000000000000000000
00000000000000000000000000000000000000000000000000000000000000000000000000000000
00000000000000000000000000000000000000000000000000000000000000000000000000000000
00000000000000000000000000000000000000000000000000000000000000000000000000000000
00000000000000000000000000000000000000000000000000000000000000000000000000000000
00000000000000000000000000000000000000000000000000000000000000000000000000000000
00000000000000000000000000000000000000000000000000000000000000000000000000000000
00000000000000000000000000000000000000000000000000000000000000000000000000000000
00000000000000000000000000000000000000000000000000000000000000000000000000000000
00000000000000000000000000000000000000000000000000000000000000000000000000000000
00000000000000000000000000000000000000000000000000000000000000000000000000000000
00000000000000000000000000000000000000000000000000000000000000000000000000000000
00001100000111111110000000000000000000000000000000000000000000000000000000000000
00001111111111111000000000000000000000000000000000000000000000000000000000000000
01000111111011111000000000000000000000000000000000000000000000000000000000000000
01000000010111111000000000000000000000000000000000000000000000000000000000000000
01000000010001111000000000000000000000000000000000000000000000000000000000000000
01111000111000111100001110000000000000000000000000000000000000000000000000000000
01111110011100111111111011000000000000000000000000000000000000000000000000000000
01100110000111111100000000000000000000000000000000000000000000000000000000000000
00000110000010001100000000000000000000000000000000000000000000000000000000000000
00001110000010000000000000000000000000000000000000000000000000000000000000000000
01111100001111111000111000100000000000000000000000000000000000000000000000000000
01111110011111111000100111100011110000000000000000000000000000000000000000000000
00110111111000110001100010000110010000000000000000000000000000000000000000000000
00010001101000000001100010000111000000000000000000000000000000000000000000000000
00010001100100001000111111000011000000000000000000000000000000000000000000000000
00011100111100011100111111100001100000000000000000000000000000000000000000000000
00001111111100111111111111100111000000000000000000000000000000000000000000000000
00000111111000110011100111101100000000000000000000000000000000000000000000000000
00000011100000110000000111011000000000000000000000000000000000000000000000000000
01000001111000111000000011011000000000000000000000000000000000000000000000000000
01100111111100111111100011111111000000000000000000000000000000000000000000000000
01111111111100111111110011111111001110000000000000000000000000000000000000000000
00111101111100111121111001111111001000000000000000000000000000000000000000000000
01111000111110011111110000010001011000000000000000000000000000000000000000000000
01001100011111001111110000000011111000000000000000000000000000000000000000000000
00001110011111111100110000000011010110000000000000000000000000000000000000000000
01001100001111111111110000000010011110000000000000000000000000000000000000000000
01101100001101110011000000000011111100000000000000000000000000000000000000000000
01111100011100000000000000000011100000000000000000000000000000000000000000000000
01111000011111000000000000000000000000000000000000000000000000000000000000000000
00000000000000000000000000000000000000000000000000000000000000000000000000000000
