80 80
00000000000000000000000000000000000000000000000000000000000000000000000000000000
00000000000000000000000000000000000000000000000000000000000000000000000000000000
00000000000000000000000000000000000000000000000000000000000000000000000000000000
00000000000000000000000000000000000000000000000000000000000000000000000000000000
00000000000000000000000000000000000000000000000000000000000000000000000000000000
00000000000000000000000000000000000000000000000000000000000000000000000000000000
00000000000000000000000000000000000000000000000000000000000000000000000000000000
00000000000000000000000000000000000000000000000000000000000000000000000000000000
00000000000000000000000000000000000000000000000000000000000000000000000000000000
00000000000000000000000000000000000000000000000000000000000000000000000000000000
00000000000000000000000000000000000000000000000000000000000000000000000000000000
00000000000000000000000000000000000000000000000000000000000000000000000000000000
00000000000000000000000000000000000000000000000000000000000000000000000000000000
00000000000000000000000000000000000000000000000000000000000000000000000000000000
00000000000000000000000000000000000000000000000000000000000000000000000000000000
00000000000000000000000000000000000000000000000000000000000000000000000000000000
00000000000000000000000000000000000000000000000000000000000000000000000000000000
00000000000000000000000000000000000000000000000000000000000000000000000000000000
00000000000000000000000000000000000000000000000000000000000000000000000000000000
00000000000000000000000000000000000000000000000000000000000000000000000000000000
00000000000000000000000000000000000000000000000000000000000000000000000000000000
00000000000000000000000000000000000000000000000000000000000000000000000000000000
00000000000000000000000000000000000000000000000000000000000000000000000000000000
00000000000000000000000000000000000000000000000000000000000000000000000000000000
00000000000000000000000000000000000000000000000000000000000000000000000000000000
00000000000000000000000000000000000000000000000000000000000000000000000000000000
00000000000000000000000000000000000000000000000000000000000000000000000000000000
00000000000000000000000000000000000000000000000000000000000000000000000000000000
00000000000000000000000000000000000000000000000000000000000000000000000000000000
00000000000000000000000000000000000000000000000000000000000000000000000000000000
00000000000000000000000000000000000000000000000000100000000000000000000000000000
00000000000000000000000000000000000000000000000001100000100000000000000000000000
00000000000000000000000000000000000000000000000000100000100000000000000000000000
00000000000000000000000000000000000000000000000000110000100000000000000000000000
00000000000000000000000000000000000000000000000000111001100001000000000000000000
00000000000000000000000000000000000000000000000001110001000111011110000000000000
00000000000000000000000000000000000000000000000000110111000110011000000000000000
00000000000000000000000000000000000000000000000001111110000110110000000000000000
00000000000000000000000000000000000000000000000000100000000111111110000000000000
00000000000000000000000000000000000000000000000000100000100111111111001101000000
00000000000000000000000000000000000000000000000001110111111111111111011101111100
00000000000000000000000000000000000000000000000000011110011111111111111001001100
00000000000000000000000000000000000000000000000000000000011111111111110001111100
00000000000000000000000000000000000000000000000000000000011111100111000001111100
00000000000000000000000000000000000000000000011000011001111111000110001111111100
00000000000000000000000000000000000000000000010000111111111111001110111111111110
00000000000000000000000000000000000000000000010001101111001111111100111111111000
00000000000000000000000000000000000000000000110000101110011111111000111111110000
00000000000000000000000000000000000000000000111100011100100001111011111111110000
00000000000000000000000000000000000000000000111111111111100011111111111100111000
00000000000000000000000000000000000000000000111111111111100111111111111100111110
00000000000000000000000000000000000000000000111100111111000111111111111100111110
00000000000000000000000000000000000000000000011000011100001111111121111100011110
00000000000000000000000000000000000000000000011000011000011111111111111111111000
00000000000000000000000000000000000000000000010000110001111111111111111111111000
00000000000000000000000000000000000000000000010000110011111111111111111111111110
00000000000000000000000000000000000000000000110001100011001111111111111100111110
00000000000000000000000000000000000000000000110001110110001111111111111000001110
00000000000000000000000000000000000000000000100001100110001111111111111111001110
00000000000000000000000000000000000000000000111001100011101111111111111111111110
00000000000000000000000000000000000000011111111000100011101111111111111111111110
00000000000000000000000000000000000000000111111000110011100111111111111110111110
00000000000000000000000000000000000000001111111000111001110111111101111110000010
00000000000000000000000000000000000000001110110000011011110111111000111110000010
00000000000000000000000000000000000000001100110000111111100111111110111111111110
00000000000000000000000000000000000000011100010001111111100111111111111111111110
00000000000000000000000000000000000000000100011011110111100011111111011111111110
00000000000000000000000000000000000000000000001111111011100001111111101110000010
00000000000000000000000000000000000000000000100010111001110000111111111100110110
00000000000000000000000000000000000100001000110001111101111111111111111101111100
00000000000000000000000000000000000100111100010001111111111111111111111101111110
00000000000000000000000000000000000111111100011000100111001111111111111111111110
00000000000000000000000000000000000011111100011100000100001000011111001111110110
00000000000000000000000000000000000000111000010110000100011100001111111111110010
00000000000000000000000000000000000000011000010011101111111111111111111111110000
00000000000000000000000000000000000000001111110001111111111111111111111111110000
00000000000000000000000000000000000000001111110000111111111111100110001111010000
00000000000000000000000000000000000000000011100000001110000111000000000110000000
00000000000000000000000000000000000000000001100000000110000001000000000110000000
00000000000000000000000000000000000000000000000000000000000000000000000000000000
