80 80
00000000000000000000000000000000000000000000000000000000000000000000000000000000
00000000000000000000000000000000000000000000000000000000000000000000000000000000
00000000000000000000000000000000000000000000000000000000000000000000000000000000
00000000000000000000000000000000000000000000000000000000000000000000000000000000
00000000000000000000000000000000000000000000000000000000000000000000000000000000
00000000000000000000000000000000000000000000000000000000000000000000000000000000
00000000000000000000000000000000000000000000000000000000000000000000000000000000
00000000000000000000000000000000000000000000000000000000000000000000000000000000
00000000000000000000000000000000000000000000000000000000000000000000000000000000
00000000000000000000000000000000000000000000000000000000000000000000000000000000
00000000000000000000000000000000000000000000000000000000000000011110000000000000
00000000000000000000000000000000000000000000000000000000000000011110000000000000
00000000000000000000000000000000000000000000000000000000000000001111110000000000
00000000000000000000000000000000000000000000000000000000001000011111100000000000
00000000000000000000000000000000000000000000000000000000001100011101000011000000
00000000000000000000000000000000000000000000000000000000000111001111111111110000
00000000000000000000000000000000000000000000000000000000000001100111100001010000
00000000000000000000000000000000000000000000000000000000000000110001000001110000
00000000000000000000000000000000000000000000000000000000000001111101000001110000
00000000000000000000000000000000000000000000000000000000000011111111100100110000
00000000000000000000000000000000000000000000000000000000000011111111111100011000
00000000000000000000000000000000000000000000000000000000000110011111111000011100
00000000000000000000000000000000000000000000000000000000000100001111100000010100
00000000000000000000000000000000000000000000000000000000000000001111100000000000
00000000000000000000000000000000000000000000000000000000000010001100111000000000
00000000000000000000000000000000000000000000000000000000000010000110011100000000
00000000000000000000000000000000000000000000000000000000000010000110001100000000
00000000000000000000000000000000000000000000000000000000010010001110011100000000
00000000000000000000000000000000000000000000000000000000010011111111111110000000
00000000000000000000000000000000000000000000000000000000010011011111111111111000
00000000000000000000000000000000000000000000000000000011110010011111111111111110
00000000000000000000000000000000000000000000000000000000100110001101111101111110
00000000000000000000000000000000000000000000000000000001111111000000110000111110
00000000000000000000000000000000000000000000000000000011111111100001111000111110
00000000000000000000000000000000000000000000000000000111001111101111111000111110
00000000000000000000000000000000000000000000000000000111111111111111111100111110
00000000000000000000000000000000000000000000000000000000111111111111111100111110
00000000000000000000000000000000000000000000000000000000011111001111111100111100
00000000000000000000000000000000000000000000000000000000001110000110111110011110
00000000000000000000000000000000000000000000000000110010000110001110011110011000
00000000000000000000000000000000000000000000000000100111100111001110011111111000
00000000000000000000000000000000000000000000000000100001110011001110011111110000
00000000000000000000000000000000000000000000000001111111110011111100111111110000
00000000000000000000000000000000000000000000000011111111110011111101111001110000
00000000000000000000000000000000000000000000001111111111111111111111011100111000
00000000000000000000000000000000000000000000111001110111111111111111011100111000
00000000000000000000000000000000000000000000000001110011111111111111011100111000
00000000000000000000000000000000000000000000000000111000011111111111111111111000
00000000000000000000000000000000000000000000001000111011111111111111111000001100
00000000000000000000000000000000000000000000011000110111111111111111111000011100
00000000000000000000000000000000000000000000111001110111111111011111111100011000
00000000000000000000000000000000000000000011111111100011111111001111111100110000
00000000000000000000000000000000000000000001111010000011111100000011111100100000
00000000000000000000000000000000000000000000011011000111111100000001111100100000
00000000000000000000000000000011000100000000011011111111111110011111111111110000
00000000000000000000000000000011111100011110010001111111111111111111111111111000
00000000000000000000000000000000110100111110110001111111110011110111111110011000
00000000000000000000000000000000000111110011111001111111110011100000110010000000
00000000000000000000000000000000001111011001100111111111110111110000110010000000
00000000000000000000000000000000001100011100111111111111111111111110011011000000
00000000000000000000000000000000001110011100111111211111100111111110011100000000
00000000000000000000000000000000000110011000011111111111000011111111001100000000
00000000000000000000000000000000000100010000011111111111000011100001000000000000
00000000000000000000000000000000001100010001111111111111000110000000000000000000
00000000000000000000000000000000000100011001110011111011000110000000000000000000
00000000000000000000000000000000000100011110111111111011000010000000000000000000
00000000000000000000000000000000000100001100011111110001000011000000000000000000
00000000000000000000000000000000000110100000001001111001100010000000000000000000
00000000000000000000000000000000000011111000011000011001110010000000000000000000
00000000000000000000000000000000000111111000110000111011111110000000000000000000
00000000000000000000000000000000001111001000010001110011100111000000000000000000
00000000000000000000000000000000001100001000011001000111000011100000000000000000
00000000000000000000000000000000000001111000110000000000000010000000000000000000
00000000000000000000000000000000000011110001100000000000000000000000000000000000
00000000000000000000000000000000000110110001100000000000000000000000000000000000
00000000000000000000000000000000000100000000000000000000000000000000000000000000
00000000000000000000000000000000001100000000000000000000000000000000000000000000
00000000000000000000000000000000001000000000000000000000000000000000000000000000
00000000000000000000000000000000000000000000000000000000000000000000000000000000
00000000000000000000000000000000000000000000000000000000000000000000000000000000
