80 80
00000000000000000000000000000000000000000000000000000000000000000000000000000000
00000000000111111000000000000000111101100000011101110000000000000000000000000000
00000000000011111000000000000000111001000000001111111000000000000000000000000000
00000000000011111100000000000001111101000000001111110000000000000000000000000000
00000000000011110110100011010011111111100000001101110001000000000000000000000000
00000000000000111111100001111110001111111110111001110001000000000000000000000000
00000000000000011111100001111110001111100001100001110011000100000000000000000000
00000000000000001111000001111111000111110001000011100011100100000000000000000000
00000000000000111110000111111111100010111100000111011111111111100000000000000000
00000000000001111110011001111110000000001100011111111111111111100000000000000000
00000000000001111111110011111110000111111100011111111111111111100000000000000000
00000000000001111000000011111111111001111000011111111111110111100000000000000000
00000000000001111000000011111110110001111100001111001111100011000000000000000000
00000000000011111000000011111110000011111111001111011111100011000000000000000000
00000000000001110000000011111100000111111111111111111111100010000000000000000000
00000000000001111000000011111111000111111111111111110011100010000000000000000000
00000000000001110000000011111000001111111111111111100011000010000000000000000000
00000000000011100000000011110000001111111121111111000111000000000000000000000000
00000000000101110000000111100000011111111111111111100100100000000000000000000000
00000000011101110001100111110011011111111111111111111101100000000000000000000000
00000000111111111000100111111110011111111111111111111111000000000000000000000000
00000000111111111100111111111111011111111111111111111111000000000000000000000000
00000000000011111100110001111110111111111111111111111110000000000000000000000000
00000000000011001111110011111110001001111110111111111100000000000000000000000000
00000000001110011111110011101111001111111110011111110110000000000000000000000000
01000000011100111001110001101111111111011100111111110011111111000000000000000000
01100000111000110001110001101111111100000000111111110000110000000000000000000000
01000000100001110000110000100011110000000001110011110000000000000000000000000000
01110000110000000000000000000001100000000001110001110000000000000000000000000000
01111111111111100000000000000011000000000111110001110000000000000000000000000000
01111111111111111000000000000111000000001100111001110000000000000000000000000000
01001111111110001000000000000100000000000000011111100000000000000000000000000000
00000111111110000100000000000000000000000000011110000000000000000000000000000000
00000001111100000110000000000000000000000000011110000100000000000000000000000000
00001111111110111111100000000000000000000000011110111110000000000000000000000000
00011111111111111101100000000000000000000000010011100111000000000000000000000000
01110011110000111100100000000000000000000000000011100001111000000000000000000000
00000000000001111111000000000000000000000000000000000000111000000000000000000000
00000000000001100000000000000000000000000000000000000000111000000000000000000000
00000000000000100000000000000000000000000000000000000001101110000000000000000000
00000000000000111000000000000000000000000000000000000011100111000000000000000000
00000000000000001100000000000000000000000000000000000011000010000000000000000000
00000000000000000000000000000000000000000000000000000000000000000000000000000000
00000000000000000000000000000000000000000000000000000000000000000000000000000000
00000000000000000000000000000000000000000000000000000000000000000000000000000000
00000000000000000000000000000000000000000000000000000000000000000000000000000000
00000000000000000000000000000000000000000000000000000000000000000000000000000000
00000000000000000000000000000000000000000000000000000000000000000000000000000000
00000000000000000000000000000000000000000000000000000000000000000000000000000000
00000000000000000000000000000000000000000000000000000000000000000000000000000000
00000000000000000000000000000000000000000000000000000000000000000000000000000000
00000000000000000000000000000000000000000000000000000000000000000000000000000000
00000000000000000000000000000000000000000000000000000000000000000000000000000000
00000000000000000000000000000000000000000000000000000000000000000000000000000000
00000000000000000000000000000000000000000000000000000000000000000000000000000000
00000000000000000000000000000000000000000000000000000000000000000000000000000000
00000000000000000000000000000000000000000000000000000000000000000000000000000000
00000000000000000000000000000000000000000000000000000000000000000000000000000000
00000000000000000000000000000000000000000000000000000000000000000000000000000000
00000000000000000000000000000000000000000000000000000000000000000000000000000000
00000000000000000000000000000000000000000000000000000000000000000000000000000000
00000000000000000000000000000000000000000000000000000000000000000000000000000000
00000000000000000000000000000000000000000000000000000000000000000000000000000000
00000000000000000000000000000000000000000000000000000000000000000000000000000000
00000000000000000000000000000000000000000000000000000000000000000000000000000000
00000000000000000000000000000000000000000000000000000000000000000000000000000000
00000000000000000000000000000000000000000000000000000000000000000000000000000000
00000000000000000000000000000000000000000000000000000000000000000000000000000000
00000000000000000000000000000000000000000000000000000000000000000000000000000000
00000000000000000000000000000000000000000000000000000000000000000000000000000000
00000000000000000000000000000000000000000000000000000000000000000000000000000000
00000000000000000000000000000000000000000000000000000000000000000000000000000000
00000000000000000000000000000000000000000000000000000000000000000000000000000000
00000000000000000000000000000000000000000000000000000000000000000000000000000000
00000000000000000000000000000000000000000000000000000000000000000000000000000000
00000000000000000000000000000000000000000000000000000000000000000000000000000000
00000000000000000000000000000000000000000000000000000000000000000000000000000000
00000000000000000000000000000000000000000000000000000000000000000000000000000000
00000000000000000000000000000000000000000000000000000000000000000000000000000000
00000000000000000000000000000000000000000000000000000000000000000000000000000000
