80 80
00000000000000000000000000000000000000000000000000000000000000000000000000000000
00000111011111111111111111111111111111111100110000000000000000000000000000000000
00000011111011001111111100111000011111111111100000000000000000000000000000000000
00111111111011100011111101111000001111011111110000000000000000000000000000000000
01111111111101111001111111111111101110011111110010000000000000000000000000000000
01111111111100111001111111111111111111011111110110000000000000000000000000000000
00111111111100111101111111101111111100111111011110000000000000000000000000000000
00111111111111111111111111000111101111110011110000000000000000000000000000000000
00111110111111111111111111000111111111100001100000000000000000000000000000000000
00011110111111111211111111100111111111110111110000000000000000000000000000000000
00001111111111111111111111100111111111111100111000000000000000000000000000000000
00000111011111111111111111100011111111111000011100000000000000000000000000000000
00000111111111100110111000111111111111111000000111000000000000000000000000000000
00000001111110000100011000111111111111111110000000000000000001000000000000000000
00000011111110011101111001111111101110011100100000001001001011000010000000000000
00001111111100111111111111111111101110111110111111111001111110001110000000000000
00011000111101111111111111101111111100111110011110010011001110011000000000000000
00010000110000110111100011000011111100111110000100011111011100110000000000000000
00001001000000011111100011111011111000111100001111111001111100100000000000000000
00001111000000011100100011001111001111011100011111110001111111100100000000000000
00000111111111111000100001000111101111111111111111110011111111100100000000000000
00001111100000110001100001100111111110111101111111111111011111111100000000000000
00001000000000000001000011100001001111111111111111111100001111111000100000000000
00011000000001110001000111110000001111111111111001111100001111000000110000000000
00011100110011110000101101100000001111111001110001110111001110000110011000000000
00000111111110010000111111000000001111111110110001110011111110001110011100000000
00000111001100010000100110000000001110000110011001110011111111001100011100000000
00000111101110000000000100000000000000000111111001110011111111001100011100000000
00110111111100000000000100000000000000000000111011100011111111001110011000000000
01110111111000000000000000000000000000000000011111110011101111001111111000000000
00011111011000000000000000000000000000000000011011110011111111001111111000000000
00000000000000000000000000000000000000000000000011110001111111001101101110000000
00000000000000000000000000000000000000000000000011110000000011111000100000000000
00000000000000000000000000000000000000000000000001111000000011111000110000000000
00000000000000000000000000000000000000000000000001111111100011111110111000000000
00000000000000000000000000000000000000000000000001111111111111001110011100000000
00000000000000000000000000000000000000000000000001111111111110001110001100000000
00000000000000000000000000000000000000000000000000011111111110000001000110000000
00000000000000000000000000000000000000000000000000001111100110000001100010000000
00000000000000000000000000000000000000000000000000001111100111001111111011100000
00000000000000000000000000000000000000000000000011111011000111111111111111111100
00000000000000000000000000000000000000000000000000010011000011111111001111111110
00000000000000000000000000000000000000000000000000000111000001111111100011000010
00000000000000000000000000000000000000000000000000000001000000111111110001100000
00000000000000000000000000000000000000000000000000000001111111111111000000110000
00000000000000000000000000000000000000000000000000000011100111111110000000010000
00000000000000000000000000000000000000000000000000000010000011111100000000011000
00000000000000000000000000000000000000000000000000000000000000110000000000001100
00000000000000000000000000000000000000000000000000000000000000110000100000000110
00000000000000000000000000000000000000000000000000000000000011111101110000110000
00000000000000000000000000000000000000000000000000000000000111111111111100010000
00000000000000000000000000000000000000000000000000000000000110110011111000110000
00000000000000000000000000000000000000000000000000000000000000100000111000110000
00000000000000000000000000000000000000000000000000000000000000000000011111100000
00000000000000000000000000000000000000000000000000000000000110000010001111110000
00000000000000000000000000000000000000000000000000000000000011001110001111111110
00000000000000000000000000000000000000000000000000000000000011111100011000000000
00000000000000000000000000000000000000000000000000000000000011111111111100000000
00000000000000000000000000000000000000000000000000000000000001100111111110000000
00000000000000000000000000000000000000000000000000000000000001100111111000000000
00000000000000000000000000000000000000000000000000000000000111001110011100000000
00000000000000000000000000000000000000000000000000000000000000011000001100000000
00000000000000000000000000000000000000000000000000000000000000011100011100000000
00000000000000000000000000000000000000000000000000000000000000011111111100000000
00000000000000000000000000000000000000000000000000000000000001111111101110000000
00000000000000000000000000000000000000000000000000000000000011111111111100000000
00000000000000000000000000000000000000000000000000000000000000010000000000000000
00000000000000000000000000000000000000000000000000000000000000000000000000000000
00000000000000000000000000000000000000000000000000000000000000000000000000000000
00000000000000000000000000000000000000000000000000000000000000000000000000000000
00000000000000000000000000000000000000000000000000000000000000000000000000000000
00000000000000000000000000000000000000000000000000000000000000000000000000000000
00000000000000000000000000000000000000000000000000000000000000000000000000000000
00000000000000000000000000000000000000000000000000000000000000000000000000000000
00000000000000000000000000000000000000000000000000000000000000000000000000000000
00000000000000000000000000000000000000000000000000000000000000000000000000000000
00000000000000000000000000000000000000000000000000000000000000000000000000000000
00000000000000000000000000000000000000000000000000000000000000000000000000000000
00000000000000000000000000000000000000000000000000000000000000000000000000000000
00000000000000000000000000000000000000000000000000000000000000000000000000000000
