80 80
00000000000000000000000000000000000000000000000000000000000000000000000000000000
00000000000000000000000000000000000000000000000000000000000000000000000000000000
00000000000000000000000000000000000000000000000000000000000000000000000000000000
00000000000000000000000000000000000000000000000000000000000000000000000000000000
00000000000000000000000000000000000000000000000000000000000000000000000000000000
00000000000000000000000000000000000000000000000000000000000000000000000000000000
00000000000000000000000000000000000000000000000000000000000000000000000000000000
00000000000000000000000000000000000000000000000000000000000000000000000000000000
00000000000000000000000000000000000000000000000000000000000000000000000000000000
00000000000000000000000000000000000000000000000000000000000000000000000000000000
00000000000000000000000000000000000000000000000000000000000000000000000000000000
00000000000000000000000000000000000000000000000000000000000000000000000000000000
00000000000000000000000000000000000000000000000000000000000000000000000000000000
00000000000000000000000000000000000000000000000000000000000000000000000000000000
00000000000000000000000000000000000000000000000000000000000000000000000000000000
00000000000000000000000000000000000000000000000000000000000000000000000000000000
00000000000000000000000000000000000000000000000000000000000000000000000000000000
00000000000000000000000000000000000000000000000000000000000000000000000000000000
00000000000000000000000000000000000000000000000000000000000000000000000000000000
00000000000000000000000000000000000000000000000000000000000000000000000000000000
00000000000000000000000000000000000000000000000000000000000000000000000000000000
00000000000000000000000000000000000000000000000000000000000000000000000000000000
00000000000000000000000000000000000000000000000000000000000000000000000000000000
00000000000000000000000000000000000000000000000000000000000000000000000000000000
01000100000000000000000000000000000000000000000000000000000000000000000000000000
01111100000000000000000000000000000000000000000000000000000000000000000000000000
01100100000000000000000000000000000000000000000000000000000000000000000000000000
01101110000000000000000000000000000000000000000000000000000000000000000000000000
01011110000000000000000000000000000000000000000000000000000000000000000000000000
00011110000000000000000000000000000000000000000000000000000000000000000000000000
01011110000000000000000000000000000000000000000000000000000000000000000000000000
01110111000000000000000000000000000000000000000000000000000000000000000000000000
01000001000000000000000000000000000000000000000000000000000000000000000000000000
00000001000000000000000000000000000000000000000000000000000000000000000000000000
01000011100000000000000000000000000000000000000000000000000000000000000000000000
01111111111100000000000000000000000000000000000000000000000000000000000000000000
01111001100000000000000000000000000000000000000000000000000000000000000000000000
00010000100000000000000000000000000000000000000000000000000000000000000000000000
00110000000010000000000000000000000000000000000000000000000000000000000000000000
01111100001110000000000000000000000000000000000000000000000000000000000000000000
01001111001000000000000000000000000000000000000000000000000000000000000000000000
00000110011000000000000000000000000000000000000000000000000000000000000000000000
00000011110000000000000000000000000000000000000000000000000000000000000000000000
00000011000000001000000000000000000000000000000000000000000000000000000000000000
00000110001000011000111000000000000000000000000000000000000000000000000000000000
01001110011110010001111111100000000000000000000000000000000000000000000000000000
01111100110111110001111000000000000000000000000000000000000000000000000000000000
01111101100011100001110000000000000000000000000000000000000000000000000000000000
01100111001110000000010000000000000000000000000000000000000000000000000000000000
01100110011111010000110000000000000000000000000000000000000000000000000000000000
01111110011111110000100000000000000000000000000000000000000000000000000000000000
01111100011111010001100100000000000000000000000000000000000000000000000000000000
01111110011100000001000100000000000000000000000000000000000000000000000000000000
01111111111000011111011111000000000000000000000000000000000000000000000000000000
01111111111000011111111110000000000000000000000000000000000000000000000000000000
01111111111000011011111111000000000000000000000000000000000000000000000000000000
00001111011100110001111000000000000000000000000000000000000000000000000000000000
00000011111100110001101000000000000000000000000000000000000000000000000000000000
00000011111100110001000000000000000000000000000000000000000000000000000000000000
00000111111100110011100000000000000000000000000000000000000000000000000000000000
00001111111110111111100000000000000000000000000000000000000000000000000000000000
00001111111110111110110000000000000000000000000000000000000000000000000000000000
01001111110011111110111000000000000000000000000000000000000000000000000000000000
01111111110001111211101100000000000000000000000000000000000000000000000000000000
01111111111000111111101111000000000000000000000000000000000000000000000000000000
01011110011100111111111011000000000000000000000000000000000000000000000000000000
01011110001100111100111001100000000000000000000000000000000000000000000000000000
01111110011001100000010000000000000000000000000000000000000000000000000000000000
01111111111000000000000000000000000000000000000000000000000000000000000000000000
01001110011000000000000000000000000000000000000000000000000000000000000000000000
01111111001000000000000000000000000000000000000000000000000000000000000000000000
01111111001000000000000000000000000000000000000000000000000000000000000000000000
01100001110000000000000000000000000000000000000000000000000000000000000000000000
01000011100000000000000000000000000000000000000000000000000000000000000000000000
01000000000000000000000000000000000000000000000000000000000000000000000000000000
00000000000000000000000000000000000000000000000000000000000000000000000000000000
00000000000000000000000000000000000000000000000000000000000000000000000000000000
00000000000000000000000000000000000000000000000000000000000000000000000000000000
00000000000000000000000000000000000000000000000000000000000000000000000000000000
00000000000000000000000000000000000000000000000000000000000000000000000000000000
