80 80
00000000000000000000000000000000000000000000000000000000000000000000000000000000
00000000000000000000000000000000000000000000000000000000000000000000000000000000
00000000000000000000000000000000000000000000000000000000000000000000000000000000
00000000000000000000000000000000000000000000000000000000000000000000000000000000
00000000000000000000000000000000000000000000000000000000000000000000000000000000
00000000000000000000000000000000000000000000000000000000000000000000000000000000
00000000000000000000000000000000000000000000000000000000000000000000000000000000
00000000000000000000000000000000000000000000000000000000000000000000000000000000
00000000000000000000000000000000000000000000000000000000000000000000000000000000
00000000000000000000000000000000000000000000000000000000000000000000000000000000
00000000000000000000000000000000000000000000000000000000000000000000000000000000
00000000000000000000000000000000000000000000000000000000000000000000000000000000
00000000000000000000000000000000000000000000000000000000000000000000000000000000
00000000000000000000000000000000000000000000000000000000000000000000000000000000
00000000000000000000000000000000000000000000000000000000000000000000000000000000
00000000000000000000000000000000000000000000000000000000000000000000000000000000
00000000000000000000000000000000000000000000000000000000000000000000000000000000
00000000000000000000000000000000000000000000000000000000000000000000000000000000
00000000000000000000000000000000000000000000000000000000000000000000000000000000
00000000000000000000000000000000000000000000000000000000000000000000000000000000
00000000000000000000000000000000000000000000000000000000000000000000000000000000
00000000000000000000000000000000000000000000000000000000000000000000000000000000
00000000000000000000000000000000000000000000000000000000000000000000000000000000
00000000000000000000000000000000000000000000000000000000000000000000000000000000
00000000000000000000000000000000000000000000000000000000000000000000000000000000
00000000000000000000000000000000000000000000000000000000000000000000000000000000
00000000000000000000000000000000000000000000000000000000000000000000000000000000
00000000000000000000000000000000000000000000000000000000000000000000000000000000
00000000000000000000000000000000000000000000000000000000000000000000000000000000
00000000000000000000000000000000000000000000000000000000000000000000000000000000
00000000000000000000000000000000000000000000000000000000000000000000000000000000
00000000000000000000000000000000000000000000000000000000000000000000000000000000
00000000000000000000000000000000000000000000000000000000000000000000000000000000
00000000000000000000000000000000000000000000000000000000000000000000000000000000
00000000000000000000000000000000000000000000000000000000000000000000000000000000
00000000000000000000000000000000000000000000000000000000000000000000000000000000
00000000000000000000000000000000000000000000000000000000000000000000000000000000
00000000000000000000000000000000000000000000000000000000000000000000000000000000
00000000000000000000000000000000000000000000000000000000000000000000000000000000
00000000000000000000000000000000000000000000000000000000000000000000000000000000
00000000000000000000000000000000000000000000000000000000000000000000000000000000
00000000000000000000000000000000000000000000000000000000000000000000000000000000
00000000000000000000000000000000000000000000000000000000000000000000000000000000
00000000000000000000000000000000000000000000000000000000000000000000000000000000
00000000000000000000000000000000000000000000000000000000000000000010000000000000
00000000000000000000000000000000000000000000000000000000000000001111000000000000
00000000000000000000000000000000000000000000000000000000000000001001000000000000
00000000000000000000000000000000000000000000000000100000000000111111000000000000
00000000000000000000000000000000000000000000000001100000000011001111000000000000
00000000000000000000000000000000000000000000000000100000000010001100111000000000
00000000000000000000000000000000000000000000000000100000000010000111111101111110
00000000000000000000000000000000000000000000000000100000000010000111001111001100
00000000000000000000000000000000000000000000000000100000011110000111000010000000
00000000000000000000000000000000000000000000000001100000011111011101000010001000
00000000000000000000000000000000000000000000000001100111111111111101001111011000
00000000000000000000000000000000000000000000000001111111111111111111011111111110
00000000000000000000000000000000000000000000000000111101111111100010011011110010
00000000000000000000000000000000000000000000000000011000001111110000011011110010
00000000000000000000000000000000000000000000000000010000000000111100001111110010
00000000000000000000000000000000000000000000000000100011100001101100001111110000
00000000000000000000000000000000000000000000000000100011111111000100001111010000
00000000000000000000000000000000000000000000000000100001111000001100011111011110
00000000000000000000000000000000000000000000000000110000000000011100011110001100
00000000000000000000000000000000000000000000000111111100000000011000101110000000
00000000000000000000000000000000000000000000000001100000001110111111111110000000
00000000000000000000000000000000000000000000000000110000000111111111111100000000
00000000000000000000000000000000000000000000000000110000000011111211111000000000
00000000000000000000000000000000000000000000000000011000001111111111110000000000
00000000000000000000000000000000000000000000000000111000011111111111110000000000
00000000000000000000000000000000000000000000000000111111110011111100111000000000
00000000000000000000000000000000000000000000000000110011100111111110011100000000
00000000000000000000000000000000000000000000000000000011101110111111001000000000
00000000000000000000000000000000000000000000000000000000011000010001100000000000
00000000000000000000000000000000000000000000000000000000111000011000110000000000
00000000000000000000000000000000000000000000000000000001111111001100011000000000
00000000000000000000000000000000000000000000000000000011101111101100001000000000
00000000000000000000000000000000000000000000000000000011001111111100011000000000
00000000000000000000000000000000000000000000000000000000011111111110000000000000
00000000000000000000000000000000000000000000000000000001111111111111100000000000
00000000000000000000000000000000000000000000000000000000000000000000000000000000
