80 80
00000000000000000000000000000000000000000000000000000000000000000000000000000000
00000000000000000000000000000000000000000000000000000000000000000000000000000000
00000000000000000000000000000000000000000000000000000000000000000000000000000000
00000000000000000000000000000000000000000000000000000000000000000000000000000000
00000000000000000000000000000000000000000000000000000000000000000000000000000000
00000000000000000000000000000000000000000000000000000000000000000000000000000000
00000000000000000000000000000000000000000000000000000000000000000000000000000000
00000000000000000000000000000000000000000000000000000000000000000000000000000000
00000000000000000000000000000000000000000000000000000000000000000000000000000000
00000000000000000000000000000000000000000000000000000000000000000000000000000000
00000000000000000000000000000000000000000000000000000000000000000000000000000000
00000000000000000000000000000000000000000000000000000000000000000000000000000000
00000000000000000000000000000000000000000000000000000000000000000000000000000000
00000000111100000000000000000000000000000000000000000000000000000000000000000000
00000000011000010000000000000000000000000000000000000000000011100000000000000000
00000000011100010000000000000000000000000000000000000001000011100000000000000000
00000000000110010000000000000000000000000000000000000011001111100000000000000000
00000000000111110000000000000000000000000000000000000010011011100000000000000000
00000000000111111000011000000000000000000000000000000011011000000000000000000000
00001100001111011000010000000000000000000000000000000011001011000000000000000000
00011110001111110001110000000000000000000000000000000011111111100000000000000000
00000110011011110000100000000000000000000000000000000001111111100000000000000000
00000111111011111001111000000000000000000000000000000001111100110001000000000000
00111111001110011111110000000000000000000000000000000001100110011001000010000000
00111110001100111101100000000000000000010000000000000001100010001111110010000000
01111110011100111101110000000000000000011100000000000011000010000110011110000000
01111110011000111101110000000000000000000110000000000011000010001110000000100000
01111111111111111111110000000000000000000011000000001111000111001110000000100000
01111111111110011111111110000000000000000001000000000111111110000010000001100000
01111111101100011111111111000000000000000001100011000001100110000111100001111110
01111211111100111111110011000000000000000000111111110011100111001111111111111100
01111111111000111111100011000000000000000000001000111111100011111100000011111000
01111111111001111111000011100000000000000000000000011100111011110000000001000000
01111111111111111111000110000000000000000000000000011100001111110000000000000000
01111111111111111011100111000000000000000000000001111111000111111100001000000000
01111111111111111001110011100000000000000000111111111111100111111110011100000000
01111111111111110000011000110000000000000000111111111101110111111110001100000000
01111100111000000000001000000000000000000000111111111000011111111110001110000000
01011110010000000000001000000000000000000000011111111000011110001111111000000000
01001110111100011111111000000111000110011000011011111000111110001111111000000000
01001111111110111011111111111111111111111000010001111111111111001111111000000000
00001111111111110000111100011111111111101100110001111111111111000111101100000000
00001100111111111000000000001100111111001011100001111110011110000011101100000000
00000000011110011110000000000100100111100011000111111111111100000011111100000000
00000110011100011111000001000111000111111111111111111111111110000111111000000000
00001111111100111001110001000011000111111111111111111111111111111110011000000000
00011111111000110000011011000011000001101111111111111111110011111100001100000000
00011111110000100000001111000000000000100011111111111110110000011000011111000000
01111111110001100000011111000000000000100011011100111100010000000010111000000000
01001111111011110000111111111000000000011110011001111111110011000110001000000000
01001111111111111000111111101111000000011110111001111111111111111110001000000000
00001111101111001111101111100010000000001111110001111111001111111110001000000000
00000001000010000011111111111110110000000011100011110000001100110011000000000000
00000000000011000010111111100111110000000011000111111000000110011001100001000000
00001100001111100010111111000011001100011111011100111111000110001100110111000000
00001110011111111111110011000111000100011111111001110111100110000100011100000000
00000110011011001110100001100110000100011110110001110001110011000110010000000000
00000110100001000110000001111000000110000110000001110000011111000111000000000000
00000111100001000010000001111000001110000111110000111000011111000111000000000000
00000111100011110011000001111100001110001111111111111110111111000110110000000000
00000100111111111001110001101111111110011111111111111111110111000100111000000000
00000100000011111100111011000001111110011111111111111111100110000100100000000000
00000000000001111111111000000000111111111001111111111000001100001111100000000000
00001000000000000111111110000000111111111111111111110000011000011101100000000000
00001100100001001111111111100011111111111111111011110001110011101100000000000000
00000110111111111111110011110111111111111111111001110011101111000101000000000000
00000111111111100001110011111110001111111111111000111011101110000111000000000000
00000011111111000001110111111000001111111111111000111011111100000000000000000000
00000111111100111001111111110000001111111111111001111011111111100000000000000000
00000110011000011001111111111011111111111111111111110011111111110000000000000000
00000100011100111001111111111111111111111111111111110111111111111111111000000000
00000100000110110001111111111110111111111111111111111111111111110000000000000000
00000110000011111001001111111100011111111101110111111111111000000000000000000000
01101111000011111110000111111001111110011111110011111111110000000000000000000000
01111111001111110011100111111111001110011111111001111011110000000000000000000000
01111111111111111111111111100111001110011111111111110011111110000000000000000000
01111111111011111100111111000111111110011101111111100011110000000000000000000000
01100001100001111111110011111111111100011001001110000111110000000000000000000000
01000001100001111101100011100111111100111011001100011111110000000000000000000000
00000000000000000000000000000000000000000000000000000000000000000000000000000000
