80 80
00000000000000000000000000000000000000000000000000000000000000000000000000000000
00000000000000000000000000000000000000000000000000000000000000000000000000000000
00000000000000000000000000000000000000000000000000000000000000000000000000000000
00000000000000000000000000000000000000000000000000000000000000000000000000000000
00000000000000000000000000000000000000000000000000000000000000000000000000000000
00000000000000000000000000000000000000000000000000000000000000000000000000000000
00000000000000000000000000000000000000000000000000000000000000000000000000000000
00000000000000000000000000000000000000000000000000000000000000000000000000000000
00000000000000000000000000000000000000000000000000000000000000000000000000000000
00000000000000000000000000000000000000000000000000000000000000000000000000000000
00000000000000000000000000000000000000000000000000000000000000000000000000000000
00000000000000000000000000000000000000000000000000000000000000000000000000000000
00000000000000000000000000000000000000000000000000000000000000000000000000000000
00000000000000000000000000000000000000000000000000000000000000000000000000000000
00000000000000000000000000000000000000000000000000000000000000000000000000000000
00000000000000000000000000000000000000000000000000000000000000000000000000000000
00000000000000000000000000000000000000000000000000000000000000000000000000000000
00000000000000000000000000000000000000000000000000000000000000000000000000000000
00000000000000000000000000000000000000000000000000000000000000000000000000000000
00000000000000000000000000000000000000000000000000000000000000000000000000000000
00000000000000000000000000000000000000000000000000000000000000000000000000000000
00000000000000000000000000000000000000000000000000000000000000000000000000000000
00000000000000000000000000000000000000000000000000000000000000000000000000000000
00000000000000000000000000000000000000000000000000000000000000000000000000000000
00000000000000000000000000000000000000000000000000000000000000000000000000000000
00000000000000000000000000000000000000000000000000000000000000000000000000000000
00000000000000000000000000000000000000000000000000000000000000000000000000000000
00000000000000000000000000000000000000000000000000000000000000000000000000000000
00000000000000000000000000000000000000000000000000000000000000000000000000000000
00000000000000000000000000000000000000000000000000000000000000000000000000000000
00000000000000000000000000000000000000000000000000000000000000000000000000000000
00000000000000000000000000000000000000000000000000000000000000000000000000000000
00000000000000000000000000000000000000000000000000000000000000000000000000000000
00000000000000000000000000000000000000000000000000000000000000000000000000000000
00000000000000000000000000000000000000000000000000000000000000000000000000000000
00000000000000000000000000000000000000000000000000000000000000000000000000000000
00000000000000000000000000000000000000000000000000000000000000000000000000000000
00000000000000000000000000000000000000000000000000000000000000000000000000000000
00000000000000000000000000000000000000000000000000000000000000000000000000000000
00000000000000000000000000000000000000000000000000000000000000000000000000000000
00000000000000000000000000000000000000000000000000000000000000000000000000000000
00000000000000000000000000000000000000000000000000000000000000000000000000000000
00000000000000000000000000000000000000000000000000000000000000000000000000000000
00000000000000000000000000000000000000000000000000000000000000000000000000000000
00000000000000000000000000000000000000000000000000000000000000000000000000000000
00000000000000000000000000000000000000000000000000000000000000000000000000000000
00000000000000000000000000000000000000000000001000000000000000000000000000000000
00000000000000000000000000000000000000000000001100000000000000000000000000000000
00001000000000000000000000000000000000000000011110000000000000000000000000000000
00001000000000000000000000000000000000000000011111100000000000000000000000000000
00001110000000000000000000000000000000000000111001110000000000000000000000000000
01000110000000000000000000000000000000000001111000110000000000000000000000000000
01101111000000000000000000000000000000000001100000111000000000000000000000000000
00111100000000000000000000000000000000000001111100111000000000000000000000000000
00111101110000110000100000000000000000010001111101110110000110000000000000000000
01111110011100010000100000000000000001111111111101100011100010000101000000000000
01111110001100011001100000000000000001100111111111110000110011000101110000000000
00110111111001110001100000000000100001000011110100110000010010000111110000000000
00111111110001110011111000010000100001000011100100010000111110010010110000000000
01111111111010111011111101110001111001001111110100110001100110111110010000000000
01111111111110111111111111100111111111011111111111110011100111111100000000000000
01111111101111111111111111001100000110011011111111100011000011111100000000000000
00111111000111111110011100000000000001100001100001000010000000111110000000000000
01111111101111111110001000011110001111100001100001000110000000011110000000000000
01001111111111121110011001111111001111111000110001100111111110111100000000000000
01001111111111111011110011111111001111111100111001110011111111111100000000000000
00000110001111111001100011001111011110011110011001110011100011100000000000000000
00001111001111011000000110000110001110001110001101110111000000000000000000000000
00011111111111111000111110000000001110011100001101111111111110000001110000000000
00011111111111111101110011101110001110011100011101111111111110000011010000000000
00011111111111111001110111111111001110011111111001111111111110001110000000000000
00000001111110111001100111110111111100001111110000111111111110001100000000000000
00000000001100011111100110000001111000000111110001111111111110011000000000000000
00000000001100011110000110000011110000000110011111111111111100110100000000000000
00000000001100011000111111000111010010001100011111111111111111111100000000000000
00000000001000011001111011000011011111111000111111111111111111101100000000000000
00000000011000110011111001100011011001110000110011111111100111000000000000000000
00000000011000111111011101100111111000000001100001111100001111000000000000000000
00000001111111111111111111111100111000000001000000011100000000000000000000000000
00000000000000000000000000000000000000000000000000000000000000000000000000000000
