80 80
00000000000000000000000000000000000000000000000000000000000000000000000000000000
00000000000000000000000000000000000000000000000000000000000000000000000000000000
00000000000000000000000000000000000000000000000000000000000000000000000000000000
00000000000000000000000000000000000000000000000000000000000000000000000000000000
00000000000000000000000000000000000000000000000000000000000000000000000000000000
00000000000000000000000000000000000000000000000000000000000000000000000000000000
00000000000000000000000000000000000000000000000000000000000000000000000000000000
00000000000000000000000000000000000000000000000000000000000000000000000000000000
00000000000000000000000000000000000000000000000000000000000000000000000000000000
00000000000000000000000000000000000000000000000000000000000000000000000000000000
00000000000000000000000000000000000000000000000000000000000000000000000000000000
00000000000000000000000000000000000000000000000000000000000000000000000000000000
00000000000000000000000000000000000000000000000000000000000000000000000000000000
00000000000000000000000000000000000000000000000000000000000000000000000000000000
00000000000000000000000000000000000000000000000000000000000000000000000000000000
00000000000000000000000000000000000000000000000000000000000000000000000000000000
00000000000000000000000000000000000000000000000000000000000000000000000000000000
00000000000000000000000000000000000000000000000000000000000000000000000000000000
00000000000000000000000000000000000000000000000000000000000000011000000000000000
00000000000000000000000000000000000000000000000000000000000011101100000000000000
00000000000000000000000000000000000000000000000000000000000111001110000000000000
00000000000000000000000000000000000000000000000000000100000110000110000000000000
00000000000000000000000000000000000000000000000000001100000110000010000000000000
00000000000000000000000000000000000000000000000000001100111111000010000000000000
00000000000000000000000000000000000000000000000000011111111111111110000000000000
00000000000000000000000000000000000000000000000000000011111111111110000000000000
00000000000000000000000000000000000000000000000011000011111111111100000000000000
00000000000000000000000000000000000000000000000010000000111111110000000000000000
00000000000000000000000000000000000000000000001110000000000111110000000000000000
00000000000000000000000000000000000000000000011011000000000111111100000000000000
00000000000000000000000000000000000000000000010011110111111111111111000000000000
00000000000000000000000000000000000000000000010000011100111111111110000000000000
00000000000000000000000000000000000000000000110000001000011111111100000000000000
00000000000000000000000000000000000000000000011000001100011111111100000000000000
00000000000000000000000000000000000000000000011100011111111011001100000000000000
00000000000000000000000000000000000000000000011111110011111111000100000000000000
00000000000000000000000000000000000000000000011111000011111110000111000000000000
00000000000000000000000000000000000000000000011110000011111100000111000000000000
00000000000000000000000000000000000000000000000000000011111100000000000000000000
00000000000000000000000000000000000000000000000000000011111110001110000000000000
00000000000000000000000000000000000000000000000000000011111111001111000000000000
00000000000000000000000000000000000000000000000000000011111011011110000000000000
00000000000000000000000000000000000000000000000000000011111110110000000000000000
00000000000000000000000000000000000000000000000000000111111111110000000000000000
00000000000000000000000000000000000000000000000000001111112111110000000000000000
00000000000000000000000000000000000000000000000000001111111111111110000000000000
00000000000000000000000000000000000000000000000000000011111111110000000000000000
00000000000000000000000000000000000000000000000000000011111111100000000000000000
00000000000000000000000000000000000000000000000000000000000001100000000000000000
00000000000000000000000000000000000000000000000000000001000011110100000000000000
00000000000000000000000000000000000000000000000000000001111111111100000000000000
00000000000000000000000000000000000000000000000000000000011110111100000000000000
00000000000000000000000000000000000000000000000000000000011100000000000000000000
00000000000000000000000000000000000000000000000000000000001100000000000000000000
00000000000000000000000000000000000000000000000000000000000000000000000000000000
00000000000000000000000000000000000000000000000000000000000000000000000000000000
00000000000000000000000000000000000000000000000000000000000000000000000000000000
00000000000000000000000000000000000000000000000000000000000000000000000000000000
00000000000000000000000000000000000000000000000000000000000000000000000000000000
00000000000000000000000000000000000000000000000000000000000000000000000000000000
00000000000000000000000000000000000000000000000000000000000000000000000000000000
00000000000000000000000000000000000000000000000000000000000000000000000000000000
00000000000000000000000000000000000000000000000000000000000000000000000000000000
00000000000000000000000000000000000000000000000000000000000000000000000000000000
00000000000000000000000000000000000000000000000000000000000000000000000000000000
00000000000000000000000000000000000000000000000000000000000000000000000000000000
00000000000000000000000000000000000000000000000000000000000000000000000000000000
00000000000000000000000000000000000000000000000000000000000000000000000000000000
00000000000000000000000000000000000000000000000000000000000000000000000000000000
00000000000000000000000000000000000000000000000000000000000000000000000000000000
00000000000000000000000000000000000000000000000000000000000000000000000000000000
00000000000000000000000000000000000000000000000000000000000000000000000000000000
00000000000000000000000000000000000000000000000000000000000000000000000000000000
00000000000000000000000000000000000000000000000000000000000000000000000000000000
00000000000000000000000000000000000000000000000000000000000000000000000000000000
00000000000000000000000000000000000000000000000000000000000000000000000000000000
00000000000000000000000000000000000000000000000000000000000000000000000000000000
00000000000000000000000000000000000000000000000000000000000000000000000000000000
00000000000000000000000000000000000000000000000000000000000000000000000000000000
00000000000000000000000000000000000000000000000000000000000000000000000000000000
