80 80
00000000000000000000000000000000000000000000000000000000000000000000000000000000
00000000000000000000000000000000011110111000111100000000000000000000000000000000
00000000000000000000000000000000000111111001111100000000000000000000000000000000
00000000000000000000000000000000000111111001111000000000000000000000000000000000
00000000000000000000000000000000000111111001110000000000000000000000000000000000
00000000000000000000000000000111001111111000010000000000000000000000000000000000
00000000000000000000000000000011000111111000011000000000000000000000000000000000
00000000000000000000000000000111000000111110011000000000000000000000000000000000
00000000000000000000000000001111100000001111011100001000000000000000000000000000
00000000000000000000000000000011111000001111111100001111000000000000000000000000
00000000000000000001111111111111111110011111121111111011000000000000000000000000
00000000000000000000000000001110000111011111111111000001100000000000000000000000
00000000000000000000000000000110000011011111100010000000110000000000000000000000
00000000000000000000000000000111100110001111100011000000000000000000000000000000
00000000000000000000000000000111111110001111110001100000000000000000000000000000
00000000000000000000000000000011111110011111111001111111001111000000000000000000
00000000000000000000000000000011111110111011111000111001111000000000000000000000
00000000000000000000000000000000011100100001111100111100110000000000000000000000
00000000000000000000000000000000001100100000111111111111000000000000000000000000
00000000000000000000000000000000001101111000011111111011000000000000000000000000
00000000000000000000000000000000001111111110111111111001000000000000000000000000
00000000000000000000000000000000000110111111110011110001000000000000000000000000
00000000000000000000000000000000000000011111110000000011000000000000000000000000
00000000000000000000000000000000000000000011111100000110000000000000000000000000
00000000000000000000000000000000000000010011111110011110000000000000000000000000
00000000000000000000000000000000000000111111111111111111100000000000000000000000
00000000000000000000000000000000000000000000111111000100100000000000000000000000
00000000000000000000000000000000000000000001110000000110000000000000000000000000
00000000000000000000000000000000000000000111100000000011000000000000000000000000
00000000000000000000000000000000000011111111100000000001000000000000000000000000
00000000000000000000000000000000000111111111111001110001000000000000000000000000
00000000000000000000000000000000000000111110001100011111000000000000000000000000
00000000000000000000000000000000000000000010000000000000000000000000000000000000
00000000000000000000000000000000000000000000000000000000000000000000000000000000
00000000000000000000000000000000000000000000000000000000000000000000000000000000
00000000000000000000000000000000000000000000000000000000000000000000000000000000
00000000000000000000000000000000000000000000000000000000000000000000000000000000
00000000000000000000000000000000000000000000000000000000000000000000000000000000
00000000000000000000000000000000000000000000000000000000000000000000000000000000
00000000000000000000000000000000000000000000000000000000000000000000000000000000
00000000000000000000000000000000000000000000000000000000000000000000000000000000
00000000000000000000000000000000000000000000000000000000000000000000000000000000
00000000000000000000000000000000000000000000000000000000000000000000000000000000
00000000000000000000000000000000000000000000000000000000000000000000000000000000
00000000000000000000000000000000000000000000000000000000000000000000000000000000
00000000000000000000000000000000000000000000000000000000000000000000000000000000
00000000000000000000000000000000000000000000000000000000000000000000000000000000
00000000000000000000000000000000000000000000000000000000000000000000000000000000
00000000000000000000000000000000000000000000000000000000000000000000000000000000
00000000000000000000000000000000000000000000000000000000000000000000000000000000
00000000000000000000000000000000000000000000000000000000000000000000000000000000
00000000000000000000000000000000000000000000000000000000000000000000000000000000
00000000000000000000000000000000000000000000000000000000000000000000000000000000
00000000000000000000000000000000000000000000000000000000000000000000000000000000
00000000000000000000000000000000000000000000000000000000000000000000000000000000
00000000000000000000000000000000000000000000000000000000000000000000000000000000
00000000000000000000000000000000000000000000000000000000000000000000000000000000
00000000000000000000000000000000000000000000000000000000000000000000000000000000
00000000000000000000000000000000000000000000000000000000000000000000000000000000
00000000000000000000000000000000000000000000000000000000000000000000000000000000
00000000000000000000000000000000000000000000000000000000000000000000000000000000
00000000000000000000000000000000000000000000000000000000000000000000000000000000
00000000000000000000000000000000000000000000000000000000000000000000000000000000
00000000000000000000000000000000000000000000000000000000000000000000000000000000
00000000000000000000000000000000000000000000000000000000000000000000000000000000
00000000000000000000000000000000000000000000000000000000000000000000000000000000
00000000000000000000000000000000000000000000000000000000000000000000000000000000
00000000000000000000000000000000000000000000000000000000000000000000000000000000
00000000000000000000000000000000000000000000000000000000000000000000000000000000
00000000000000000000000000000000000000000000000000000000000000000000000000000000
00000000000000000000000000000000000000000000000000000000000000000000000000000000
00000000000000000000000000000000000000000000000000000000000000000000000000000000
00000000000000000000000000000000000000000000000000000000000000000000000000000000
00000000000000000000000000000000000000000000000000000000000000000000000000000000
00000000000000000000000000000000000000000000000000000000000000000000000000000000
00000000000000000000000000000000000000000000000000000000000000000000000000000000
00000000000000000000000000000000000000000000000000000000000000000000000000000000
00000000000000000000000000000000000000000000000000000000000000000000000000000000
00000000000000000000000000000000000000000000000000000000000000000000000000000000
00000000000000000000000000000000000000000000000000000000000000000000000000000000
