80 80
00000000000000000000000000000000000000000000000000000000000000000000000000000000
00000000000000000000000000000000000000000000000000000000000000000000000000000000
00000000000000000000000000000000000000000000000000000000000000000000000000000000
00000000000000000000000000000000000000000000000000000000000000000000000000000000
00000000000000000000000000000000000000000000000000000000000000000000000000000000
00000000000000000000000000000000000000000000000000000000000000000000000000000000
00000000000000000000000000000000000000000000000000000000000000000000000000000000
00000000000000000000000000000000000000000000000000000000000000000000000000000000
00000000000000000000000000000000000000000000000000000000000000000000000000000000
00000000000000000000000000000000000000000000000000000000000000000000000000000000
00000000000000000000000000000000000000000000000000000000000000000000000000000000
00000000000000000000000000000000000000000000000000000000000000000000000000000000
00000000000000000000000000000000000000000000000000000000000000000000000000000000
00000000000000000000000000000000000000000000000000000000000000000000000000000000
00000000000000000000000000000000000000000000000000000000000000000000000000000000
00000000000000000000000000000000000000000000000000000000000000000000000000000000
00000000000000000000000000000000000000000000000000000000000000000000000000000000
00000000001000000000000000000000000000000000000000000000000000000000000000000000
00000000001000000000000000000000000000000000000000000000000000000000000000000000
00000000001000000000000000000000000000000000000000000000000000000000000000000000
00000000001000000000000000000000000000000000000000000000000000000000000000000000
00000000001000000000000000000000000000000000000000000000000000000000000000000000
00000000001100000000000000000000000000000000000000000000000000000000000000000000
00000000001100011000000000000000000000000000000000000000000000000000000000000000
00000000111000011000000000000000000000000000000000000000000000000000000000000000
01000000111100110000000000000000000000000000000000000000000000000000000000000000
01000000111101110000000000000000000000000000000000000000000000000000000000000000
01110000111111111011000000000000000000000000000000000000000000000000000000000000
01110000111111111101110000000000000000000000000000000000000000000000000000000000
01111111111110110000110011000000000000000000000000000000000000000000000000000000
01111111111110010000110011110000000000000000000000000000000000000000000000000000
00011111111110010001100111110000000000000000000000000000000000000000000000000000
00000110000010000001000100110000000000000000000000000000000000000000000000000000
00000111101110000111000100100010000000000000000000000000000000000000000000000000
00000110011110001111111111100111000000000000000000000000000000000000000000000000
00000100011111111101111111100111100000000000000000000000000000000000000000000000
00001110011111111000111111100111100000000000000000000000000000000000000000000000
00011111111111111000001111111100000000000000000000000000000000000000000000000000
00011111111111111110000111111100000000000000000000000000000000000000000000000000
00001100011000011111100111001111000000000000000000000000000000000000000000000000
01101110111111111111111111100111000000000000000000000000000000000000000000000000
01111111011111110110111111000111000000000000000000000000000000000000000000000000
00111111111100000010001111000111000000000000000000000000000000000000000000000000
01111211111011100010000110001110000000000000000000000000000000000000000000000000
01111111111110110000000010011110000000000000000000000000000000000000000000000000
01111111111100110000000011110010000000000000000000000000000000000000000000000000
01111110000000011000000000000010000000000000000000000000000000000000000000000000
01111110000000001000000000000010000000000000000000000000000000000000000000000000
01111111000000000100000000000011000000000000000000000000000000000000000000000000
01111110000000001100000000000011000000000000000000000000000000000000000000000000
01111110011111111100000000000010000000000000000000000000000000000000000000000000
01111111001111000000000000000110000000000000000000000000000000000000000000000000
01111111111100000000000000011100000000000000000000000000000000000000000000000000
01011111111100000000000011011000000000000000000000000000000000000000000000000000
01011111111100011000000001001010000000000000000000000000000000000000000000000000
00001111111101111100000001011110000000000000000000000000000000000000000000000000
00000111111001111100000001111010000000000000000000000000000000000000000000000000
00000000100001100000000001111110000000000000000000000000000000000000000000000000
00000000000001001100000000111100000000000000000000000000000000000000000000000000
00000000110011111100010001110000000000000000000000000000000000000000000000000000
00000000011111111111111111100111100000000000000000000000000000000000000000000000
00000000000111111000000111001100100000000000000000000000000000000000000000000000
00010000000000011100000110111000000000000000000000000000000000000000000000000000
00010000000000000000000100010000000000000000000000000000000000000000000000000000
00110011100000110000001100111000000000000000000000000000000000000000000000000000
01111110011111111001111111111111000000000000000000000000000000000000000000000000
01111100000010011000001111000000000000000000000000000000000000000000000000000000
00111000000000001100000111000000000000000000000000000000000000000000000000000000
00111000000000111100000111100000000000000000000000000000000000000000000000000000
01111100000111011100000111100000000000000000000000000000000000000000000000000000
01111100111111111111111111100000000000000000000000000000000000000000000000000000
00111111111111100011101111100000000000000000000000000000000000000000000000000000
00011100001110000001000111100000000000000000000000000000000000000000000000000000
00011000011100000011100111100000000000000000000000000000000000000000000000000000
00000000011000000111111111110000000000000000000000000000000000000000000000000000
00000000001000011111100111100000000000000000000000000000000000000000000000000000
00000000001000010111100000000000000000000000000000000000000000000000000000000000
00000000000000000010110000000000000000000000000000000000000000000000000000000000
00000000000000000010010000000000000000000000000000000000000000000000000000000000
00000000000000000000000000000000000000000000000000000000000000000000000000000000
