80 80
00000000000000000000000000000000000000000000000000000000000000000000000000000000
01101100000000011000000000000000000000000000000000000000000000000000000000000000
00111100000001111000000000000000000000000000000000000000000000000000000000000000
00110100000011111100000000001000000000000000000000000000000000000000000000000000
00100100000011111111100001011000000000000000000000000000000000000000000000000000
01101100011111111111111111111110000000000000000000000000000000000000000000000000
00001100111111111001110000011100000000000000000000000000000000000000000000000000
00111000111111111110000000001100000000000000000000000000000000000000000000000000
01110000011111111111000000011110000000000000000000000000000000000000000000000000
01011100001111111011100001110000000000000000000000000000000000000000000000000000
00011110011101111001110011100000000000000000000000000000000000000000000000000000
00110111111000011100110011000000000000000000000000000000000000000000000000000000
00100001100000111000110000000000000000000000000000000000000000000000000000000000
00100001110001111001110000000000000000000000000000000000000000000000000000000000
00000001111101110001100001100000000000000000000000000000000000000000000000000000
00001111111100111001110011110000000000000000000000000000000000000000000000000000
00000000011100011000110011111000000000000000000000000000000000000000000000000000
00000000000100111100011011111100000000000000000000000000000000000000000000000000
00000000000011111100001111111000000000000000000000000000000000000000000000000000
00000000001111111100111111111100000000000000000000000000000000000000000000000000
00000000001111111011111111111110000000000000000000000000000000000000000000000000
00000000000001110001000011110001000000000000000000000000000000000000000000000000
00000000000000000000000011110001000000000000000000000000000000000000000000000000
00000000000000000011000011011011100000000000000000000000000000000000000000000000
00000000000000000111100001011010000000000000000000000000000000000000000000000000
00000000000000000000100001111010000000000000000000000000000000000000000000000000
00000000000000000000110001001110000000000000000000000000000000000000000000000000
00000000000000000000110001111000000000000000000000000000000000000000000000000000
00000000000000100001111001110000000000000000000000000000000000000000000000000000
00000000001001110011111111100000000000000000000000000000000000000000000000000000
00000000001011111111111111100000000000000000000000000000000000000000000000000000
00000000001111011111111111000000000000000000000000000000000000000000000000000000
00000000001111001111111100000000000000000000000000000000000000000000000000000000
00010010011100111111111000000000000000000000000000000000000000000000000000000000
00111110011100011000100000000000000000000000000000000000000000000000000000000000
00001111011100011100100000000000000000000000000000000000000000000000000000000000
00001111111000110000100000000000000000000000000000000000000000000000000000000000
00001111110000110000110000000000000000000000000000000000000000000000000000000000
00000001000000100000111000011000000000000000000000000000000000000000000000000000
00000011000100110011111111111100000000000000000000000000000000000000000000000000
00001111111110111001111111111111000000000000000000000000000000000000000000000000
00001000110010011101111011110000000000000000000000000000000000000000000000000000
00000000100001001110000001100000000000000000000000000000000000000000000000000000
00111001100001100110000000000000000000000000000000000000000000000000000000000000
01101100111000111111111001000000000000000000000000000000000000000000000000000000
01001110011100111011111111100000000000000000000000000000000000000000000000000000
00000110001100011001110010000000000000000000000000000000000000000000000000000000
00000011000000001100000000000000000000000000000000000000000000000000000000000000
00000111100000001110000010000000000000000000000000000000000000000000000000000000
00001100110000011111100111000000000000000000000000000000000000000000000000000000
00001111111100111111111111100000000000000000000000000000000000000000000000000000
00000011100111110011111001100000000000000000000000000000000000000000000000000000
00000000000011100010011000000000000000000000000000000000000000000000000000000000
00000000000001100110011000000000000000000000000000000000000000000000000000000000
00000000011111111110111100100000000000000000000000000000000000000000000000000000
00001111111111111111111111110000000000000000000000000000000000000000000000000000
00000111111111111111100011010000000000000000000000000000000000000000000000000000
00000111111121111111100010011000000000000000000000000000000000000000000000000000
00001111111111111001100111100000000000000000000000000000000000000000000000000000
00011111111111111001111111100000000000000000000000000000000000000000000000000000
01111111111111110000111111100000000000000000000000000000000000000000000000000000
01001110001011110001110111100000000000000000000000000000000000000000000000000000
01100100000000000011101111100000000000000000000000000000000000000000000000000000
01100000000000001111111111110000000000000000000000000000000000000000000000000000
01000000000000011000111001110000000000000000000000000000000000000000000000000000
00000000000000111001110011110000000000000000000000000000000000000000000000000000
00000000000000111011100011010000000000000000000000000000000000000000000000000000
00000000000000010011100011011000000000000000000000000000000000000000000000000000
00000000000000011011111111110000000000000000000000000000000000000000000000000000
00000000000000011001111111100000000000000000000000000000000000000000000000000000
00000000000000111101111011100000000000000000000000000000000000000000000000000000
00000000000000110111110001100000000000000000000000000000000000000000000000000000
00000000000000000011000000100000000000000000000000000000000000000000000000000000
00000000000000100010010000000000000000000000000000000000000000000000000000000000
00000000000000110011110000000000000000000000000000000000000000000000000000000000
00000000000000011111110000000000000000000000000000000000000000000000000000000000
00000000000000011111100000000000000000000000000000000000000000000000000000000000
00000000000000011110000000000000000000000000000000000000000000000000000000000000
00000000000000111100000000000000000000000000000000000000000000000000000000000000
00000000000000000000000000000000000000000000000000000000000000000000000000000000
