80 80
00000000000000000000000000000000000000000000000000000000000000000000000000000000
00000000000000000000000000000000000000000000000000000000000000000000000000000000
00000000000000000000000000000000000000000000000000000000000000000000000000000000
00000000000000000000000000000000000000000000000000000000000000000000000000000000
00000000000000000000000000000000000000000000000000000000000000000000000000000000
00000000000000000000000000000000000000000000000000000000000000000000000000000000
00000000000000000000000000000000000000000000000000000000000000000000000000000000
00000000000000000000000000000000000000000000000000000000000000000000000000000000
00000000000000000000000000000000000000000000000000000000000000000000000000000000
00000000000000000000000000000000000000000000000000000000000000000000000000000000
00000000000000000000000000000000000000000000000000000000000000000000000000000000
00000000000000000000000000000000000000000000000000000000000000000000000000000000
00000000000000000000000000000000010000000000000000000000000000000000000000000000
00000000000000000000000000000000010000000000000000000000000000000000000000000000
00000000000000000000000000000010011000000000000000000000000000000000000000000000
00000000000000010000000000000010011110000000000000000000000000000000000000000000
00000000000000110000000000000011110110000000000000000000000000000000000000000000
00000000000001110000000000001111100010000000000000000000000000000000000000000000
00000000000001111000001000111111000000000000000000000000000000000000000000000000
00000001111000111100111111101111000000000000000000000000000000000000000000000000
00011111011000111111111111101111000000000000000000000000000000000000000000000000
00000010001100111111101111101111000000000000000000000000000000000000000000000000
00000011111111111111001101101110100000000000000000000000000000000000000000000000
00000111111111111111001101101100110000000000000000000000000000000000000000000000
00000100011111111111101111101110110010000000000000000000000000000000000000000000
00000100011111111001111111111111111110000000000000000000000000000000000000000000
00000110011111111000111111011011111000000000000000000000000000000000000000000000
00000111011112111111110010011000010000000000000000000000000000000000000000000000
00001000111111111111100010011000000000000000000000000000000000000000000000000000
00001100111111111011100011111000000000000000000000000000000000000000000000000000
00001110011111111001110011111111000000000000000000000000000000000000000000000000
00000110001111111101110001111110000000000000000000000000000000000000000000000000
00000011001111111100110000011010010000000000000000000000000000000000000000000000
00000011111101111111110000011011110000000000000000000000000000000000000000000000
01111111111001111111110001110111010000000000000000000000000000000000000000000000
01111111011100111111111111110010000000000000000000000000000000000000000000000000
00000110001100011111111111000000000000000000000000000000000000000000000000000000
00000000001100000000111110000000000000000000000000000000000000000000000000000000
00000000001000000000000111000000000000000000000000000000000000000000000000000000
00000000011101110001100111100000000000000000000000000000000000000000000000000000
00000000011111111111111111111110000000000000000000000000000000000000000000000000
00000000001111111100111111111000000000000000000000000000000000000000000000000000
00000001000110011100001111110000000000000000000000000000000000000000000000000000
00000001000110001110001111110000000000000000000000000000000000000000000000000000
00000001001110011111111101100000000000000000000000000000000000000000000000000000
00000111111111111011111111000000000000000000000000000000000000000000000000000000
00000110011011110001111011000000000000000000000000000000000000000000000000000000
00000110001111111011110000000000000000000000000000000000000000000000000000000000
00001101101111111111110000001000000000000000000000000000000000000000000000000000
00001101101110111111101000111100000000000000000000000000000000000000000000000000
00000111111100111111111111100000000000000000000000000000000000000000000000000000
00000011110000111110011110000000000000000000000000000000000000000000000000000000
00000010000000011100000000000000000000000000000000000000000000000000000000000000
00000010000000111100000000000000000000000000000000000000000000000000000000000000
00000000000000011110000000000000000000000000000000000000000000000000000000000000
00000000000000110011110000000000000000000000000000000000000000000000000000000000
00000000000000110000000000000000000000000000000000000000000000000000000000000000
00000000000000010000000000000000000000000000000000000000000000000000000000000000
00000000000000011000000000000000000000000000000000000000000000000000000000000000
00000000000000011000000000000000000000000000000000000000000000000000000000000000
00000000000000010000000000000000000000000000000000000000000000000000000000000000
00000000000001110000000000000000000000000000000000000000000000000000000000000000
00000000000011110000000000000000000000000000000000000000000000000000000000000000
00000000000001010000000000000000000000000000000000000000000000000000000000000000
00000000000001010000000000000000000000000000000000000000000000000000000000000000
00000000000001110000000000000000000000000000000000000000000000000000000000000000
00000000000001110000000000000000000000000000000000000000000000000000000000000000
00000000000111100000000000000000000000000000000000000000000000000000000000000000
00000000000000000000000000000000000000000000000000000000000000000000000000000000
00000000000000000000000000000000000000000000000000000000000000000000000000000000
00000000000000000000000000000000000000000000000000000000000000000000000000000000
00000000000000000000000000000000000000000000000000000000000000000000000000000000
00000000000000000000000000000000000000000000000000000000000000000000000000000000
00000000000000000000000000000000000000000000000000000000000000000000000000000000
00000000000000000000000000000000000000000000000000000000000000000000000000000000
00000000000000000000000000000000000000000000000000000000000000000000000000000000
00000000000000000000000000000000000000000000000000000000000000000000000000000000
00000000000000000000000000000000000000000000000000000000000000000000000000000000
00000000000000000000000000000000000000000000000000000000000000000000000000000000
00000000000000000000000000000000000000000000000000000000000000000000000000000000
