80 80
00000000000000000000000000000000000000000000000000000000000000000000000000000000
00000000000000001111000000000000000000000000000000000000000000000000000000000000
00000000000000000110000000000000000000000000000000000000000000000000000000000000
00000000000000000010000000000000000000000000000000000000000000000000000000000000
00000000000000010010011000000000000000000000000000000000000000000000000000000000
00000000000000010011110000000000000000000000000000000000000000000000000000000000
00000000000000011011000000000000000000000000000000000000000000000000000000000000
00000000000000011110000000000000000000000000000000000000000000000000000000000000
00000000000000011111000000000000000000000000000000000000000000000000000000000000
00011100000000011111100000000000000000000000000000000000000000000000000000000000
01111111000000010111100000000000000000000000000000000000000000000000000000000000
01111110000000110110110000000000000000000000000000000000000000000000000000000000
00011100000000111110110000000000000000000000000000000000000000000000000000000000
00011110000001101111100000000000000000000000000000000000000000000000000000000000
00010111110001111101100000000000000000000000000000000000000000000000000000000000
00011110011100111100100000000000000000000000000000000000000000000000000000000000
00001000001110011000100000000000000000000000000000000000000000000000000000000000
00000000001110000000100000000000000000000000000000000000000000000000000000000000
00000000011111001100100000000000000001100000000000000000000000000000000000000000
00000000001111111111100000000000000111100000000000000000000000000000000000000000
00000000001111111101110111000000000111100000000000000000000000000000000000000000
00000000011011111100111111000000000101000000000000000000000000000000000000000000
00000000000101111110111111100000000101000000000000000000000000000000000000000000
00000000000111111111111111111000000100000000000000000000000000000000000000000000
00000011101111111111111011100010000100000000000000000000000000000000000000000000
00001111111111111111111011100011111110000000000000000000000000000000000000000000
00001000111001111111110011000110000100000000000000000000000000000000000000000000
00010000000011111100000000000110000000000000000000000000000000000000000000000000
00110000011111111100001000100110000000000000000000000000000000000000000000000000
01110000011111111100111001111011000110000000000000000000000000000000000000000000
01111111111112111111110011111110001110000000000000000000000000000000000000000000
01110111111111111111100011111110011110000000000000000000000000000000000000000000
00111011111111111110000011111110110000000000000000000000000000000000000000000000
00111111111110111110000001110011100000000000000000000000000000000000000000000000
01111111111110111111100001110011000000000000000000000000000000000000000000000000
01111111111111111001110111100111000000000000000000000000000000000000000000000000
00011111111111111000111110000110000000000000000000000000000000000000000000000000
00011111000111111000000000001100000000000000000000000000000000000000000000000000
00001100000111111000000000001000000000000000000000000000000000000000000000000000
00011100001111111111100000011000000000000000000000000000000000000000000000000000
01111110011101111101110011111110000000000000000000000000000000000000000000000000
01000011111000111100111110011100000000000000000000000000000000000000000000000000
00000001111111111111111110001100000000000000000000000000000000000000000000000000
00000000101111100000111110000110000000000000000000000000000000000000000000000000
00000000101111100000111111000000000000000000000000000000000000000000000000000000
00000000011111111000110111100000000000000000000000000000000000000000000000000000
00000000010000000111100111000000000000000000000000000000000000000000000000000000
00000000000000000011000011000000000000000000000000000000000000000000000000000000
00000000000000000011000001000000000000000000000000000000000000000000000000000000
00000000000000000111100001000000000000000000000000000000000000000000000000000000
00000000000000000000100001000000000000000000000000000000000000000000000000000000
00000000000000000000100001000000000000000000000000000000000000000000000000000000
00000000000000000000000000000000000000000000000000000000000000000000000000000000
00000000000000000000000000000000000000000000000000000000000000000000000000000000
00000000000000000000000000000000000000000000000000000000000000000000000000000000
00000000000000000000000000000000000000000000000000000000000000000000000000000000
00000000000000000000000000000000000000000000000000000000000000000000000000000000
00000000000000000000000000000000000000000000000000000000000000000000000000000000
00000000000000000000000000000000000000000000000000000000000000000000000000000000
00000000000000000000000000000000000000000000000000000000000000000000000000000000
00000000000000000000000000000000000000000000000000000000000000000000000000000000
00000000000000000000000000000000000000000000000000000000000000000000000000000000
00000000000000000000000000000000000000000000000000000000000000000000000000000000
00000000000000000000000000000000000000000000000000000000000000000000000000000000
00000000000000000000000000000000000000000000000000000000000000000000000000000000
00000000000000000000000000000000000000000000000000000000000000000000000000000000
00000000000000000000000000000000000000000000000000000000000000000000000000000000
00000000000000000000000000000000000000000000000000000000000000000000000000000000
00000000000000000000000000000000000000000000000000000000000000000000000000000000
00000000000000000000000000000000000000000000000000000000000000000000000000000000
00000000000000000000000000000000000000000000000000000000000000000000000000000000
00000000000000000000000000000000000000000000000000000000000000000000000000000000
00000000000000000000000000000000000000000000000000000000000000000000000000000000
00000000000000000000000000000000000000000000000000000000000000000000000000000000
00000000000000000000000000000000000000000000000000000000000000000000000000000000
00000000000000000000000000000000000000000000000000000000000000000000000000000000
00000000000000000000000000000000000000000000000000000000000000000000000000000000
00000000000000000000000000000000000000000000000000000000000000000000000000000000
00000000000000000000000000000000000000000000000000000000000000000000000000000000
00000000000000000000000000000000000000000000000000000000000000000000000000000000
