80 80
00000000000000000000000000000000000000000000000000000000000000000000000000000000
00000000000000000000000000000000000000000000000000000000000000000000000000000000
00000000000000000000000000000000000000000000000000000000000000000000000000000000
00000000000000000000000000000000000000000000000000000000000000000000000000000000
00000000000000000000000000000000000000000000000000000000000000000000000000000000
00000000000000000000000000000000000000000000000000000000000000000000000000000000
00000000000000000000000000000000000000000000000000000000000000000000000000000000
00000000000000000000000000000000000000000000000000000000000000000000000000000000
00000000000000000000000000000000000000000000000000000000000000000000000000000000
00000000000000000000000000000000000000000000000000000000000000000000000000000000
00000000000000000000000000000000000000000000000000000000000000000000000000000000
00000000000000000000000000000000000000000000000000000000000000000000000000000000
00000000000000000000000000000000000000000000000000000000000000000000000000000000
00000000000000000000000000000000000000000000000000000000000000000000000000000000
00000000000000000000000000000000000000000000000000000000000000000000000000000000
00000000000000000000000000000000000000000000000000000000000000000000000000000000
00000000000000000000000000000000000000000000000000000000000000000000000000000000
00000000000000000000000000000000000000000000000000000000000000000000000000000000
00000000000000000000000000000000000000000000000000000000000000000000000000000000
00000000000000000000000000000000000000000000000000000000000000000000000000000000
00000000000000000000000000000000000000000000000000000000000000000000000000000000
00000000000000000000000000000000000000000000000000000000000000000000000000000000
00000000000000000000000000000000000000000000000000000000000000000000000000000000
00000000000000000000000000000000000000000000000000000000000000000000000000000000
00000000000000000000000000000000000000000000000000000000000000000000000000000000
00000000000000000000000000000000000000000000000000000000000000000000000000000000
00000000000000000000000000000000000000000000000000000000000000000000000000000000
00000000000000000000000000000000000000000000000000000000000000000000000000000000
00000000000000000000000000000000000000000000000000000000000000000000000000000000
00000000000000000000000000000000000000000000000000000000000000000000000000000000
00000000000000000000000000000000000000000000000000000000000000000000000000000000
00000000000000000000000000000000000000000000000000000000000000000000000000000000
00000000000000000000000000000000000000000000000000000000000000000000000000000000
00000000000000000000000000000000000000000000000000000000000000000000000000000000
00000000000000000000000000000000000000000000000000000000000000000000000000000000
00000000000000000000000000000000000000000000000000000000000000000000000000000000
00000000000000000000000000000000000000000000000000000000000000000000000000000000
00000000000000000000000000000000000000000000000000000000000000000000000000000000
00000000000000000000000000000000000000000000000000000000000000000000000000000000
00000000000000000000000000000000000000000000000000000001000000000000000000000000
00000000000000000000000000000000000000000000000000000001000000000000000000000000
00000000000000000000000000000000000000000000000000000001000000000000000000000000
00000000000000000000000000000000000000000000000000000001000000000000000000000000
00000000000000000000000000000000000000000000000000000001000000000000000000000000
00000000000000000000000000000000000000000000000000000001000000000000000000000000
00000000000000000000000000000000000000000000000000000001000000000000000000000000
00000000000000000000000000000000000000000000000000000001000000000000000000000000
00000000000000000000000000000000000000000000000000000001000000000000000000000000
00000000000000000000000000000000000000000000000000000001000000000000000000000000
00000000000000000000000000000000000000000000000001000001000000000110000000000000
00000000000000000000000000000000000000000000000001110001000000000110000000000000
00000000000000000000000000000000000000000000000000110001000001001100000000000000
00000000000000000000000000000000000000000000000000011011110001101100000000000000
00000000000000000000000000000000000000000000010000011110001100111100000001000000
00000000000000000000000000000000000000000000110000111111000110111100000001110000
00000000000000000000000000000000000000000000111001111111000011111100000000111000
00000000000000000000000000000000000000000000011111110000100111111100000000011110
00000000000000000000000000000000000000000000011111000000111110001100000000001100
00000000000000000000000000000000000000000001111110000000111110000100000011011100
00000000000000000000000000000000000000000111111001100001101111000110010011111100
00000000000000000000000000000000000000011111111111110001000111001100011111111110
00000000000000000000000000000000000000110000011100110001000111111100000111111110
00000000000000000000000000000000000000110000000100110011000111111110000001111110
00000000000000000000000000000000000000110000000111110011101111111000100001100000
00000000000000000000000000000000000000011000011011111011101111111100111111111100
00000000000000000000000000000000000000011110111011111111111111111110011111111110
00000000000000000000000000000000000000001111111001111111101111001110001111110000
00000000000000000000000000000000000000000011111110001111100000000111001111000000
00000000000000000000000000000000000011000011111111000111111000011111100111100000
00000000000000000000000000000000000011110111110001110111111111111111111111110110
00000000000000000000000000000000000110111111111001111111111111111111111101111110
00000000000000000000000000000000000000000111011000111111111111101111111000111100
00000000000000000000000000000000000000000001111100011111110000000111110000000100
00000000000000000000000000000000000000000000111110011121111000000111110001000000
00000000000000000000000000000000000000000000011111111111111111001111111011011000
00000000000000000000000000000000000000111100111011111111111111111111111111111000
00000000000000000000000000000000000000001111110000111111111111111111111111100000
00000000000000000000000000000000000000000011100000000111111111111101101110000000
00000000000000000000000000000000000000000000110000000111111111111001111100000000
00000000000000000000000000000000000000000000000000000000000000000000000000000000
