80 80
00000000000000000000000000000000000000000000000000000000000000000000000000000000
00000000000000000000000000000000000000000000000000111101100111000110000000000000
00000000000000000000000000000000000000000000000001111000110011001111000000000000
00000000000000000000000000000000000000000000011111111111110011111110000000001110
00000000000000000000000000000000000000011001111101110111010011111110010000011000
00000000000000000000000000000000000000001111111101110011111111111111111100010000
00000000000000000000000000000000000000001111111111100001111110111111100100110000
00000000000000000000000000000000000000000011111011110011111000110111100001100000
00000000000000000000000000000011000000001111110001111111111000110011100000100000
00000111001000000000000000000011000110011110110001111011111111110110011000100000
00001111001000000000000000000010000110011100111011111011111111001110001101111000
00001111001100000000000000000110001100111110011111111111000100001100001111001110
00011101101110000000000000011111001101111110001110011111000000011000000010000110
00111101111110000011100000001110011111111111111000001111000000011000000011000100
01111100111111111111100010001110001110011111111000111111000011111100000111000000
01101110111111111101110011100111011110011101111111110011100111111110011100000000
01001110011001111000111001110111111111011100111111100011100110110111110000000000
00001110000001100000111000111121111111111000000100000011111000100001100000000000
01111100011001100001111111111111111111111000000000000111111100110011110000000000
01111100011111110011111111111111111111111101110001111101111111110111110000000000
01011110011111111111111111111111101111111111111111111111111111111110011100000000
00001111011110011100111111011111001111111111111110000111001110011100001111100000
00001111111110001000011100001111100111000111111100000110001100001000000111000000
00001111111110000000001100001111100011000111111110001100000000011000000011000000
00001111111111111111101111111111100111001111111110011111110000111100000000000000
00001111111111111111111111111111101111111101111111111111100000011100000000000000
00001111111111111110111111110110011111111001111111000111000000000111000000000000
00000011110000100110011100000000011111111110000100000000000000000010000000000000
00000111100000000011101110000000111110001100000100000000000000000010000000000000
00000110110000000001100011001111111100001110011000000000000000000000000000000000
00000100111111111001110001111111000100011111110000000000000000000000000000000000
00000111100110001000110001111000000110010000110000000000000000000000000000000000
00000111100000000000000001110000000010000001110000000000000000000000000000000000
00000110110000000000000001000000000010000001110000000000000000000000000000000000
00000100011000000000000001000000000000000011010000000000000000000000000000000000
00000100001000000000000001000000000000000010010000000000000000000000000000000000
00000100001000000000000000000000000000000000010000000000000000000000000000000000
00000000011000000000000000000000000000000000010000000000000000000000000000000000
00000000000000000000000000000000000000000000000000000000000000000000000000000000
00000000000000000000000000000000000000000000000000000000000000000000000000000000
00000000000000000000000000000000000000000000000000000000000000000000000000000000
00000000000000000000000000000000000000000000000000000000000000000000000000000000
00000000000000000000000000000000000000000000000000000000000000000000000000000000
00000000000000000000000000000000000000000000000000000000000000000000000000000000
00000000000000000000000000000000000000000000000000000000000000000000000000000000
00000000000000000000000000000000000000000000000000000000000000000000000000000000
00000000000000000000000000000000000000000000000000000000000000000000000000000000
00000000000000000000000000000000000000000000000000000000000000000000000000000000
00000000000000000000000000000000000000000000000000000000000000000000000000000000
00000000000000000000000000000000000000000000000000000000000000000000000000000000
00000000000000000000000000000000000000000000000000000000000000000000000000000000
00000000000000000000000000000000000000000000000000000000000000000000000000000000
00000000000000000000000000000000000000000000000000000000000000000000000000000000
00000000000000000000000000000000000000000000000000000000000000000000000000000000
00000000000000000000000000000000000000000000000000000000000000000000000000000000
00000000000000000000000000000000000000000000000000000000000000000000000000000000
00000000000000000000000000000000000000000000000000000000000000000000000000000000
00000000000000000000000000000000000000000000000000000000000000000000000000000000
00000000000000000000000000000000000000000000000000000000000000000000000000000000
00000000000000000000000000000000000000000000000000000000000000000000000000000000
00000000000000000000000000000000000000000000000000000000000000000000000000000000
00000000000000000000000000000000000000000000000000000000000000000000000000000000
00000000000000000000000000000000000000000000000000000000000000000000000000000000
00000000000000000000000000000000000000000000000000000000000000000000000000000000
00000000000000000000000000000000000000000000000000000000000000000000000000000000
00000000000000000000000000000000000000000000000000000000000000000000000000000000
00000000000000000000000000000000000000000000000000000000000000000000000000000000
00000000000000000000000000000000000000000000000000000000000000000000000000000000
00000000000000000000000000000000000000000000000000000000000000000000000000000000
00000000000000000000000000000000000000000000000000000000000000000000000000000000
00000000000000000000000000000000000000000000000000000000000000000000000000000000
00000000000000000000000000000000000000000000000000000000000000000000000000000000
00000000000000000000000000000000000000000000000000000000000000000000000000000000
00000000000000000000000000000000000000000000000000000000000000000000000000000000
00000000000000000000000000000000000000000000000000000000000000000000000000000000
00000000000000000000000000000000000000000000000000000000000000000000000000000000
00000000000000000000000000000000000000000000000000000000000000000000000000000000
00000000000000000000000000000000000000000000000000000000000000000000000000000000
00000000000000000000000000000000000000000000000000000000000000000000000000000000
00000000000000000000000000000000000000000000000000000000000000000000000000000000
