80 80
00000000000000000000000000000000000000000000000000000000000000000000000000000000
00000000000000000000000000000000000000000000000000000000000000000000000000000000
00000000000000000000000000000000000000000000000000000000000000000000000000000000
00000000000000000000000000000000000000000000000000000000000000000000000000000000
00000000000000000000000000000000000000000000000000000000000000000000000000000000
00000000000000000000000000000000000000000000000000000000000000000000000000000000
00000000000000000000000000000000000000000000000000000000000000000000000000000000
00000000000000000000000000000000000000000000000000000000000000000000000000000000
00000000000000000000000000000000000000000000000000000000000000000000000000000000
00000000000000000000000000000000000000000000000000000000000000000000000000000000
00000000000000000000000000000000000000000000000000000000000000000000000000000000
00000000000000000000000000000000000000000000000000000000000000000000000000000000
00000000000000000000000000000000000000000000000000000000000000000000000000000000
00000000000000000000000000000000000000000000000000000000000000000000000000000000
00000000000000000000000000000000000000000000000000000000000000000000000000000000
00000000000000000000000000000000000000000000000000000000000000000000000000000000
00000000000000000000000000000000000000000000000000000000000000000000000000000000
00000000000000000000000000000000000000000000000000000000000000000000000000000000
00000000000000000000000000000000000000000000000000000000000000000000000000001000
00000000000000000000000000000000000000000000000000000000000010000000001110011000
00000000000000000000000000000000000000000000000000000000000010000100001110010000
00000000000000000000000000000000000000000000000000000000000011111100001111110000
00000000000000000000000000000000000000000000000000000000000111100000011011110000
00000000000000000000000000000000000000000000000000000000000011000000011011111000
00000000000000000000000000000000000000000000000000000000000010000111111011111000
00000000000000000000000000000000000000000000000000000000000110000111101111111000
00000000000000000000000000000000000000000000000000000000000010000111101111111000
00000000000000000000000000000000000000000000000000000000000111001111001001111110
00000000000000000000000000000000000000000000000000000000000011111110000001111110
00000000000000000000000000000000000000000000000000000011000010001100001001111100
00000000000000000000000000000000000000000000000000000011101111001100001100111110
00000000000000000000000000000000000000000000000000000011110000000110001100111110
00000000000000000000000000000000000000000001000000000011100000100000000111111110
00000000000000000000000000000000000000000001100000000010010000100000100011100010
00000000000000000000000000000000000000000001100111100111110111111110111000110000
00000000000000000000000000000000000000000000111100100111111111111111111111111000
00000000000000000000000000000000000000000000001000110000011111111111100110011000
00000000000000000000000000000000000000000000001000110000001000011111100000011100
00000000000000000000000000000000000000000000001000100000001000001100000000000000
00000000000000000000000000000000000000000000011000110111001110000110000000000000
00000000000000000000000000000000000000000000010001111111111111101100000000000000
00000000000000000000000000000000000000000000010000111001111111111100000000000000
00000000000000000000000000000000000000000000000000000001110000111100000000000000
00000000000000000000000000000000000000000000000000000011110000011110000000000000
00000000000000000000000000000000000000000000000000000011211110001110000000000000
00000000000000000000000000000000000000000000000000000011111111001110111111110000
00000000000000000000000000000000000000000000000000000001111011000111110011110000
00000000000000000000000000000000000000000000000000000000000001000001000011110010
00000000000000000000000000000000000000000000000000000000000011000001000011000010
00000000000000000000000000000000000000000000000000011110000011000001000111000010
00000000000000000000000000000000000000000000000000111111100011001111111111111110
00000000000000000000000000000000000000000000000000000000100111000111111000001110
00000000000000000000000000000000000000000000000000000000110111111111110000000100
00000000000000000000000000000000000000000000000000000001111110111111111000100110
00000000000000000000000000000000000000000000000000000001111110010111001111111110
00000000000000000000000000000000000000000000000000000001010010011110011111111110
00000000000000000000000000000000000000000000000000000000010010001000011011111110
00000000000000000000000000000000000000000000000000000000000000000000011001111000
00000000000000000000000000000000000000000000000000000000000000000000010001111000
00000000000000000000000000000000000000000000000000000000000000000000011111111000
00000000000000000000000000000000000000000000000000000000000000000000011111111000
00000000000000000000000000000000000000000000000000000000000000000000000111111000
00000000000000000000000000000000000000000000000000000000000000000000000010111000
00000000000000000000000000000000000000000000000000000000000000000000000010111100
00000000000000000000000000000000000000000000000000000000000000000000001111111000
00000000000000000000000000000000000000000000000000000000000000000000011111111000
00000000000000000000000000000000000000000000000000000000000000000000011011111000
00000000000000000000000000000000000000000000000000000000000000000000111011001100
00000000000000000000000000000000000000000000000000000000000000000000001111001100
00000000000000000000000000000000000000000000000000000000000000000000001000011100
00000000000000000000000000000000000000000000000000000000000000000000001001111000
00000000000000000000000000000000000000000000000000000000000000000000001000100000
00000000000000000000000000000000000000000000000000000000000000000000000000000000
00000000000000000000000000000000000000000000000000000000000000000000000000000000
00000000000000000000000000000000000000000000000000000000000000000000000000000000
00000000000000000000000000000000000000000000000000000000000000000000000000000000
00000000000000000000000000000000000000000000000000000000000000000000000000000000
00000000000000000000000000000000000000000000000000000000000000000000000000000000
00000000000000000000000000000000000000000000000000000000000000000000000000000000
00000000000000000000000000000000000000000000000000000000000000000000000000000000
