80 80
00000000000000000000000000000000000000000000000000000000000000000000000000000000
00000000000000000000000000000000000000000000000000000000000000000000000000000000
00000000000000000000000000000000000000000000000000000000000000000000000000000000
00000000000000000000000000000000000000000000000000000000000000000000000000000000
00000000000000000000000000000000000000000000000000000000000000000000000000000000
00000000000000000000000000000000000000000000000000000000000000000000000000000000
00000000000000000000000000000000000000000000000000000000000000000000000000000000
00000000000000000000000000000000000000000000000000000000000000000000000000000000
00000000000000000000000000000000000000000000000000000000000000000000000000000000
00000000000000000000000000000000000000000000000000000000000000000000000000000000
00000000000000000000000000000000000000000000000000000000000000000000000000000000
00000000000000000000000000000000000000000000000000000000000000000000000000000000
00000000000000000000000000000000000000000000000000000000000000000000000000000000
00000000000000000000000000000000000000000000000000000000000000000000000000000000
00000000000000000000000000000000000000000000000000000000000000000000000000000000
00000000000000000000000000000000000000000000000000000000000000000000000000000000
00000000000000000000000000000000000000000000000000000000000000000000000000000000
00000000000000000000000000000000000000000000000000000000000000000000000000000000
00000000000001111100000000000000000000000000000000000000000000000000000000000000
00000000000011011100000000000000000000000000000000000000000000000000000000000000
00000000000000111100000000000000000000000000000000000000000000000000000000000000
00000000000001110000000000000000000000000000000000000000000000000000000000000000
00000000000111111110000000000000000000000000000000000000000000000000000000000000
00000000000000011100000000000000000000000000000000000000000000000000000000000000
00000000000000010000110000000000000000000000000000000000000000000000000000000000
00000000000000010001110000000000000000000000000000000000000000000000000000000000
00000000000000011001100000000000000000000000000000000000000000000000000000000000
00000000000000011111100000000000000000000000000000000000000000000000000000000000
00000000010000011111110000000000010000000000000000000000000000000000000000000000
00000000010001111111110011000000110010000000000000000000000000000000000000000000
00000000011110111111111111111111111110000000000000000000000000000000000000000000
00000000001110011111111101110010011000000000000000000000000000000000000000000000
00000000000110011111111000010000011000000000000000000000000000000000000000000000
00000000111111111111111000110011111100000000000000000000000000000000000000000000
00001000111111111111111011111011001100000000000000000000000000000000000000000000
00001111111111111121111011111110000100000000000000000000000000000000000000000000
00000001111111111111111001111110000000000000000000000000000000000000000000000000
00000000000011111111110001111000000000000000000000000000000000000000000000000000
00000000000001111111110000100000000000000000000000000000000000000000000000000000
00000000000000111111111001000000000000000000000000000000000000000000000000000000
00000000000000111001111011000000000000000000000000000000000000000000000000000000
00000000000000110001111110000000000000000000000000000000000000000000000000000000
00000000000000110000111100000000000000000000000000000000000000000000000000000000
00000000000110110001100000000000000000000000000000000000000000000000000000000000
00000000011111110001100000000000000000000000000000000000000000000000000000000000
00000000011111111001100000000000000000000000000000000000000000000000000000000000
00000000011110111101110000000000000000000000000000000000000000000000000000000000
00000000011110111100110000000000000000000000000000000000000000000000000000000000
00000000001001111110110000000000000000000000000000000000000000000000000000000000
00000000001000111010110000000000000000000000000000000000000000000000000000000000
00000000001001111011110000000000000000000000000000000000000000000000000000000000
00000000000001110011100000000000000000000000000000000000000000000000000000000000
00000000000000000000000000000000000000000000000000000000000000000000000000000000
00000000000000000000000000000000000000000000000000000000000000000000000000000000
00000000000000000000000000000000000000000000000000000000000000000000000000000000
00000000000000000000000000000000000000000000000000000000000000000000000000000000
00000000000000000000000000000000000000000000000000000000000000000000000000000000
00000000000000000000000000000000000000000000000000000000000000000000000000000000
00000000000000000000000000000000000000000000000000000000000000000000000000000000
00000000000000000000000000000000000000000000000000000000000000000000000000000000
00000000000000000000000000000000000000000000000000000000000000000000000000000000
00000000000000000000000000000000000000000000000000000000000000000000000000000000
00000000000000000000000000000000000000000000000000000000000000000000000000000000
00000000000000000000000000000000000000000000000000000000000000000000000000000000
00000000000000000000000000000000000000000000000000000000000000000000000000000000
00000000000000000000000000000000000000000000000000000000000000000000000000000000
00000000000000000000000000000000000000000000000000000000000000000000000000000000
00000000000000000000000000000000000000000000000000000000000000000000000000000000
00000000000000000000000000000000000000000000000000000000000000000000000000000000
00000000000000000000000000000000000000000000000000000000000000000000000000000000
00000000000000000000000000000000000000000000000000000000000000000000000000000000
00000000000000000000000000000000000000000000000000000000000000000000000000000000
00000000000000000000000000000000000000000000000000000000000000000000000000000000
00000000000000000000000000000000000000000000000000000000000000000000000000000000
00000000000000000000000000000000000000000000000000000000000000000000000000000000
00000000000000000000000000000000000000000000000000000000000000000000000000000000
00000000000000000000000000000000000000000000000000000000000000000000000000000000
00000000000000000000000000000000000000000000000000000000000000000000000000000000
00000000000000000000000000000000000000000000000000000000000000000000000000000000
00000000000000000000000000000000000000000000000000000000000000000000000000000000
