80 80
00000000000000000000000000000000000000000000000000000000000000000000000000000000
00000000000000000000000000000000000000000000111111100000000000000000000000000000
00000000000000000000000000000000000000000000001110000000000000000000000000000000
00000000000000000000000000000000000000000000001100000000000000000000000000000000
00000000000000000000000000000000000000001100011110000000000000000000000000000000
00000000000000000000000000000000000000011100111111110000000000000000000000000000
00000000000000000000000000000000000000011111100000010000000000000000000000000000
00000000000000000000000000000000000000001001000000000000000000000000000000000000
00000000000000000000000000000000000000000001100100010000000000000000000000000000
00000000000000000000000000000000000111000011111100110001100010000000000000000000
00000000000000000000000000000000001111111111111111110011100010000000000000000000
00000000000000000000000000000000011000100000111111100011010110000000000100000000
00000000000000000000000000000000010000000000011111100011111111110000001100000000
00000000000000000000000000000000010000000000011000111111112111110000111000000000
00000000000000000000000000000000010000000000011000111111111110011001111000000000
00000000000000000000000000000000000000001000010000100011110010001111111100000000
00000000000000000000000000000000000001001100110001100001000011000000000000000000
00000000000000000000000000000000000001111101100001100000000001000000000000000000
00000000000000000000000000000000000000111011100011110000000001000000000000000000
00000000000000000000000000000000000000011011111111111111000011000000000000000000
00000000000000000000000000000000000000011111111111111111100010000000000000000000
00000000000000000000000000000000000000000111111111111111100110000000000000000000
00000000000000000000000000000000000000000011111101101111111100000000000000000000
00000000000000000000000000000000000011000001111111100001100110100000000000000000
00000000000000000000000000000000000001100011111001100001000111110000000000000000
00000000000000000000000000000000000000111111111000100011000111100000000000000000
00000000000000000000000000000000000000000000111000111111000001100000000000000000
00000000000000000000000000000000000000000000001100001000000000100000000000000000
00000000000000000000000000000000000000000000001100000000000000100000000000000000
00000000000000000000000000000000000000000000011111000000000000000000000000000000
00000000000000000000000000000000000000000000111111110000000000000000000000000000
00000000000000000000000000000000000000000001111100010000000000000000000000000000
00000000000000000000000000000000000000000011100100010000000000000000000000000000
00000000000000000000000000000000000000000000011100000000000000000000000000000000
00000000000000000000000000000000000000000000011000000000000000000000000000000000
00000000000000000000000000000000000000000000010000000000000000000000000000000000
00000000000000000000000000000000000000000000000000000000000000000000000000000000
00000000000000000000000000000000000000000000000000000000000000000000000000000000
00000000000000000000000000000000000000000000000000000000000000000000000000000000
00000000000000000000000000000000000000000000000000000000000000000000000000000000
00000000000000000000000000000000000000000000000000000000000000000000000000000000
00000000000000000000000000000000000000000000000000000000000000000000000000000000
00000000000000000000000000000000000000000000000000000000000000000000000000000000
00000000000000000000000000000000000000000000000000000000000000000000000000000000
00000000000000000000000000000000000000000000000000000000000000000000000000000000
00000000000000000000000000000000000000000000000000000000000000000000000000000000
00000000000000000000000000000000000000000000000000000000000000000000000000000000
00000000000000000000000000000000000000000000000000000000000000000000000000000000
00000000000000000000000000000000000000000000000000000000000000000000000000000000
00000000000000000000000000000000000000000000000000000000000000000000000000000000
00000000000000000000000000000000000000000000000000000000000000000000000000000000
00000000000000000000000000000000000000000000000000000000000000000000000000000000
00000000000000000000000000000000000000000000000000000000000000000000000000000000
00000000000000000000000000000000000000000000000000000000000000000000000000000000
00000000000000000000000000000000000000000000000000000000000000000000000000000000
00000000000000000000000000000000000000000000000000000000000000000000000000000000
00000000000000000000000000000000000000000000000000000000000000000000000000000000
00000000000000000000000000000000000000000000000000000000000000000000000000000000
00000000000000000000000000000000000000000000000000000000000000000000000000000000
00000000000000000000000000000000000000000000000000000000000000000000000000000000
00000000000000000000000000000000000000000000000000000000000000000000000000000000
00000000000000000000000000000000000000000000000000000000000000000000000000000000
00000000000000000000000000000000000000000000000000000000000000000000000000000000
00000000000000000000000000000000000000000000000000000000000000000000000000000000
00000000000000000000000000000000000000000000000000000000000000000000000000000000
00000000000000000000000000000000000000000000000000000000000000000000000000000000
00000000000000000000000000000000000000000000000000000000000000000000000000000000
00000000000000000000000000000000000000000000000000000000000000000000000000000000
00000000000000000000000000000000000000000000000000000000000000000000000000000000
00000000000000000000000000000000000000000000000000000000000000000000000000000000
00000000000000000000000000000000000000000000000000000000000000000000000000000000
00000000000000000000000000000000000000000000000000000000000000000000000000000000
00000000000000000000000000000000000000000000000000000000000000000000000000000000
00000000000000000000000000000000000000000000000000000000000000000000000000000000
00000000000000000000000000000000000000000000000000000000000000000000000000000000
00000000000000000000000000000000000000000000000000000000000000000000000000000000
00000000000000000000000000000000000000000000000000000000000000000000000000000000
00000000000000000000000000000000000000000000000000000000000000000000000000000000
00000000000000000000000000000000000000000000000000000000000000000000000000000000
00000000000000000000000000000000000000000000000000000000000000000000000000000000
