80 80
00000000000000000000000000000000000000000000000000000000000000000000000000000000
00000000000000000000000000000000000000000000000000000000000000000000000000000000
00000000000000000000000000000000000000000000000000000000000000000000000000000000
00000000000000000000000000000000000000000000000000000000000000000000000000000000
00000000000000000000000000000000000000000000000000000000000000000000000000000000
00000000000000000000000000000000000000000000000000000000000000000000000000000000
00000000000000000000000000000000000000000000000000000000000000000000000000000000
00000000000000000000000000000000000000000000000000000000000000000000000000000000
00000000000000000000000000000000000000000000000000000000000000000000000000000000
00000000000000000000000000000000000000000000000000000000000000000000000000000000
00000000000000000000000000000000000000000000000000000000000000000000000000000000
00000000000000000000000000000000000000000000000000000000000000000000000000000000
00000000000000000000000000000000000000000000000000000000000000000000000000000000
00000000000000000000000000000000000000000000000000000000000000000000000000000000
00000000000000000000000000000000000000000000000000000000000000000000000000000000
00000000000000000000000000000000000000000000000000000000000000000000000000000000
00000000000000000000000000000000000000000000000000000000000000000000000000000000
00000000000000000000000000000000000000000000000000000000000000000000000000000000
00000000000000000000000000000000000000000000000000000000000000000000000000000000
00000000000000000000000000000000000000000000000000000000000000000000000000000000
00000000000000000000000000000000000000000000000000000000000000000000000000000000
00000000000000000000000000000000000000000000000000000000000000000000000000000000
00000000000000000000000000000000000000000000000000000000000000000000000000000000
00000000000000000000000000000000000000000000000000000000000000000000000000000000
00000000000000000000000000000000000000000000000000000000000000000000000000000000
00000000000000000000000000000000000000000000000000000000000000000000000000000000
00000000000000000000000000000000000000000000000000000000000000000000000000000000
00000000000000000000000000000000000000000000000000000000000000000000000000000000
00000000000000000000000000000000000000000000000000000000000000000000000000000000
00000000000000000000000000000000000000000000000000000000000000000000000000000000
00000000000000000000000000000000000000000000000000000000000000000000000000000000
00000000000000000000000000000000000000000000000000000000000000000000000000000000
00000000000000000000000000000000000000000000000000000000000000000000000000000000
00000000000000000000000000000000000000000000000000000000000000000000000000000000
00000000000000000000000000000000000000000000000000000000000000000000000000111110
00000000000000000000000000000000000000000000000000000000000000000000000000111110
00000000000000000000000000000000000000000000000000000000000000000000000000111110
00000000000000000000000000000000000000000000000000000000000000000000000001100000
00000000000000000000000000000000000000000000000000000000000000000000000000100000
00000000000000000000000000000000000000000000000000000000000000000000000110111000
00000000000000000000000000000000000000000000000000000000000000000000111111111000
00000000000000000000000000000000000000000000000000000000000000000000011001111000
00000000000000000000000000000000000000000000000000000000000000000000000001111100
00000000000000000000000000000000000000000000000000000000000000000000010001101100
00000000000000000000000000000000000000000000000000000000000001111001111101111100
00000000000000000000000000000000000000000000000000000000000111001111111111111110
00000000000000000000000000000000000000000000000000000000000110000000011111011110
00000000000000000000000000000000000000000000000000000000001110000000011111000010
00000000000000000000000000000000000000000000000000000000001111100000011101100000
00000000000000000000000000000000000001100000000000000011001110111000111000110000
00000000000000000000000000000000000000111100000000000001100111101111011100111110
00000000000000000000000000000000000000111000000000000001100001100111001100011110
00000000000000000000000000000000000000011000000000000001100000000111000110011100
00000000000000000000000000000000000000011111100000000001000000000011000011111100
00000000000000000000000000000000000000001100110011000011000001100010000011111100
00000000000000000000000000000000001111111100011111100011000111001111011111111110
00000000000000000000000000000000000011111000011100110001101110000000011111111110
00000000000000000000000000000000000000111100000000110000111100000000100110110010
00000000000000000000000000000000000000011000000001110001111111100001111111110010
00000000000000000000000000000000000000011000000011110011111111110111111100010000
00000000000000000000000000000000000000001000000011110011111111111110011100010000
00000000000000000000000000000000000000001100000001110011111011111100001100011010
00000000000000000000000000000000000000001100000000111110011000111000000100001110
00000000000000000000000000000000000000001100000000110000011000001000000100000100
00000000000000000000000000000000000000011100000001100001111100000000001100000000
00000000000000000000000000000000000000011100000001110111111111000000011100000000
00000000000000000000000000000000000000011100000000111110111011000000011000000000
00000000000000000000000000000000000000001110000000101100001111100000000000000000
00000000000000000000000000000000000000000010000000101000001111111100000000000000
00000000000000000000000000000000000000000000000001100100111112111110000000000000
00000000000000000000000000000000000000000000000000110111111111111100000000000000
00000000000000000000000000000000000000000000000000110000001110111100000000000000
00000000000000000000000000000000000000000000000000011000000000000111000000000000
00000000000000000000000000000000000000000000000000001000000000000010000000000000
00000000000000000000000000000000000000000000000000000000000000000000000000000000
00000000000000000000000000000000000000000000000000000000000000000000000000000000
00000000000000000000000000000000000000000000000000000000000000000000000000000000
00000000000000000000000000000000000000000000000000000000000000000000000000000000
00000000000000000000000000000000000000000000000000000000000000000000000000000000
00000000000000000000000000000000000000000000000000000000000000000000000000000000
