80 80
00000000000000000000000000000000000000000000000000000000000000000000000000000000
01100000000000000000000000000000000110011111011001111111111111111110011000000000
01100000000000000000000000000000000110011110001111111111111111001111001000000000
01110000000000000000000000000000000110011111000111111111111111000111001111000000
01111100001000000000000000000011001110011111111111111211111111000111001111110110
01111111101000000000000000000111111110011101111111111111111111001110011110111110
00110111111000000000000000000110011110011100111111111111111111011110111000111000
00110001111100000000000000111110110011001110000111111111111110011100110001111000
00111001111110000000000111110111110011111111110011110001111111011100101111111100
01001111111110000000111111110011110111111111110001110011111111111111111100011110
01001111111111000001111011110011011111111111111001110011111111111111111100111110
01001111111111100001100011110110011100111111111001110011111111111111111000110010
01111000111110000010000011111111000000111111111111111111111111111111111111000010
01110000011011000010000011001110110000111111111111111111111111111100011110000010
01000000001001100110000011000110011111111111111111111111111111111111011100111100
01000000001000111111110011100011001111111111111111111111111111111111111101111000
00000001001000011110000001100011001111111111111111111111111111111111111111111000
00000001111100000110000000011111001111111111111111111111111110110001111110000000
00000000001100000011000100001111001111111111111111111111111110110011111100000010
00000000011100011001100111000111001111111111111111111111111111111111111100011110
00000000011110111000100011100111101111111111111111111111111111111111111101111110
00000000111111110000110011111111100111111000111111111111110111111111111001111110
00000000110000000000111111111110111111111001111111111111110011111111111001111110
00000000010000000001111111111110011111111001110011111111111111111111111111111110
00000000011110010011111001111111001111111101110011111111111111111111111111111000
00000000011110010011111111111111001111011100111111111011101111111111111111111010
00000000011110011111110110001111111100011100011111110011000111111111101111111010
00000000011000011110111000001111111000011110001110111111000110000111000110011110
00000000011000001000010000000110011000111110001111110000111100000010000100011110
00000000011000011000111000000110111111111101111111100001111110000110001100011110
00000000001000111001110000000011111111111101111111110011100010000110001110010000
00000000001100100001100000000011110111111101111000111110000011000000011000010000
00000001111111000000110000000001000111111111111000000000000001100000000000000000
00000000011100000000111000000000000111111111111001000000000001100000000000000000
00000000001000000000100000000001000110111110111111100000000001100000000000000000
00000000001000000000100000000111101100011110111111110000000111000000000000000000
00000000000000000000110000001110111100011000111111110010000100000000000000000000
00000000000000000000010000001100111100011000011100011110000000000000000000000000
00000000000000000000000000000111001101111100011100001100000000000000000000000000
00000000000000000000000000000011001111111110011100011111000000000000000000000000
00000000000000000000000000000111001111111111111111111111100000000000000000000000
00000000000000000000000000011110000111111101110111100001100000000000000000000000
00000000000000000000000000001000000111111011000111000000000000000000000000000000
00000000000000000000000000000000000000010001001101100000000000000000000000000000
00000000000000000000000000000000000000000001011000100000000000000000000000000000
00000000000000000000000000000000000000000001110000100000000000000000000000000000
00000000000000000000000000000000000000000001100001100000000000000000000000000000
00000000000000000000000000000000000000000000000011000000000000000000000000000000
00000000000000000000000000000000000000000000000110000000000000000000000000000000
00000000000000000000000000000000000000000000000000000000000000000000000000000000
00000000000000000000000000000000000000000000000000000000000000000000000000000000
00000000000000000000000000000000000000000000000000000000000000000000000000000000
00000000000000000000000000000000000000000000000000000000000000000000000000000000
00000000000000000000000000000000000000000000000000000000000000000000000000000000
00000000000000000000000000000000000000000000000000000000000000000000000000000000
00000000000000000000000000000000000000000000000000000000000000000000000000000000
00000000000000000000000000000000000000000000000000000000000000000000000000000000
00000000000000000000000000000000000000000000000000000000000000000000000000000000
00000000000000000000000000000000000000000000000000000000000000000000000000000000
00000000000000000000000000000000000000000000000000000000000000000000000000000000
00000000000000000000000000000000000000000000000000000000000000000000000000000000
00000000000000000000000000000000000000000000000000000000000000000000000000000000
00000000000000000000000000000000000000000000000000000000000000000000000000000000
00000000000000000000000000000000000000000000000000000000000000000000000000000000
00000000000000000000000000000000000000000000000000000000000000000000000000000000
00000000000000000000000000000000000000000000000000000000000000000000000000000000
00000000000000000000000000000000000000000000000000000000000000000000000000000000
00000000000000000000000000000000000000000000000000000000000000000000000000000000
00000000000000000000000000000000000000000000000000000000000000000000000000000000
00000000000000000000000000000000000000000000000000000000000000000000000000000000
00000000000000000000000000000000000000000000000000000000000000000000000000000000
00000000000000000000000000000000000000000000000000000000000000000000000000000000
00000000000000000000000000000000000000000000000000000000000000000000000000000000
00000000000000000000000000000000000000000000000000000000000000000000000000000000
00000000000000000000000000000000000000000000000000000000000000000000000000000000
00000000000000000000000000000000000000000000000000000000000000000000000000000000
00000000000000000000000000000000000000000000000000000000000000000000000000000000
00000000000000000000000000000000000000000000000000000000000000000000000000000000
00000000000000000000000000000000000000000000000000000000000000000000000000000000
00000000000000000000000000000000000000000000000000000000000000000000000000000000
