80 80
00000000000000000000000000000000000000000000000000000000000000000000000000000000
00000000000000000000000000000000000000000000000000000000000000000000000000000000
00000000000000000000000000000000000000000000000000000000000000000000000000000000
00000000000000000000000000000000000000000000000000000000000000000000000000000000
00000000000000000000000000000000000000000000000000000000000000000000000000000000
00000000000000000000000000000000000000000000000000000000000000000000000000000000
00000000000000000000000000000000000000000000000000000000000000000000000000000000
00000000000000000000000000000000000000000000000000000000000000000000000000000000
00000000000000000000000000000000000000000000000000000000000000000000000000000000
00000000000000000000000000000000000000000000000000000000000000000001000000010000
00000000000000000000000000000000000000000000000000000000000000001111000000010000
00000000000000000000000000000000000000000000000000000000000000000010000000011000
00000000000000000000000000000000000000000000000000000000000000001110000000011000
00000000000000000000000000000000000000000000000000000000000000001100000000011000
00000000000000000000000000000000000000000000000000000000000000000100000000011000
00000000000000000000000000000000000000000000000000000000000000001110000000110000
00000000000000000000000000000000000000000000000000000000000001111100000000110000
00000000000000000000000000000000000000000000000000000000000000111000000000110000
00000000000000000000000000000000000000000000000000000000000000001110000000111110
00000000000000000000000000000000000000000000000000000000000000000110000000111000
00000000000000000000000000000000000000000000000000000000000000001110000000111000
00000000000000000000000000000000000000000000000000000000000000111100000000111100
00000000000000000000000000000000000000000000000000000000000000011000000000111110
00000000000000000000000000000000000000000000000000000000000000001100000011100100
00000000000000000000000000000000000000000000000000000000000000000100001111110000
00000000000000000000000000000000000000000000000000000000000000000100011111111110
00000000000000000000000000000000000000000000000000000000000000000100010011011110
00000000000000000000000000000000000000000000000000000000000000011100000011000010
00000000000000000000000000000000000000000000000000000000010000010000000111100010
00000000000000000000000000000000000000000000000000000011010011110010001110110000
00000000000000000000000000000000000000000000000000000001110010011111111100110000
00000000000000000000000000000000000000000000000000000001111110000000011000110000
00000000000000000000000000000000000000000000000000000000010100000000000001110000
00000000000000000000000000000000000000000000000000000000000100000000000000110000
00000000000000000000000000000000000000000000000000000000000111011100000000011000
00000000000000000000000000000000000000000000000000000000000011111110000000111110
00000000000000000000000000000000000000000000000000000000000011111110000000111110
00000000000000000000000000000000000000000000000000000000000000011110000001111100
00000000000000000000000000000000000000000000000000000000000000011111100111000000
00000000000000000000000000000000000000000000000000000000000000001111111111000000
00000000000000000000000000000000000000000000000000000000000000011111111100000000
00000000000000000000000000000000000000000000000000000000000000011112111100000000
00000000000000000000000000000000000000000000000000000000000000011111111111000000
00000000000000000000000000000000000000000000000000000000011000011111111111110000
00000000000000000000000000000000000000000000000000000001111110001111111000110010
00000000000000000000000000000000000000000000000000000011100111001111011000011110
00000000000000000000000000000000000000000000000000000010000011001111011000011110
00000000000000000000000000000000000000000000000000000000000111000111100000000010
00000000000000000000000000000000000000000000000000000000000110000011000000000010
00000000000000000000000000000000000000000000000000000000000110000111001100000110
00000000000000000000000000000000000000000000000000000000000111001110011110111110
00000000000000000000000000000000000000000000000000000000000011111100110001111100
00000000000000000000000000000000000000000000000000000000000011110001100001111110
00000000000000000000000000000000000000000000000000000000000111100011000000000110
00000000000000000000000000000000000000000000000000000000000111110110000000011110
00000000000000000000000000000000000000000000000000000000000111111110011111111100
00000000000000000000000000000000000000000000000000000000000111111100111000000000
00000000000000000000000000000000000000000000000000000000000111111100100000000000
00000000000000000000000000000000000000000000000000000000000110111100110000000000
00000000000000000000000000000000000000000000000000000000000110011100011000000000
00000000000000000000000000000000000000000000000000000000000011001100011100000000
00000000000000000000000000000000000000000000000000000000000011001100001100000000
00000000000000000000000000000000000000000000000000000000000000000000111000000000
00000000000000000000000000000000000000000000000000000000000000000000000000000000
00000000000000000000000000000000000000000000000000000000000000000000000000000000
00000000000000000000000000000000000000000000000000000000000000000000000000000000
00000000000000000000000000000000000000000000000000000000000000000000000000000000
00000000000000000000000000000000000000000000000000000000000000000000000000000000
00000000000000000000000000000000000000000000000000000000000000000000000000000000
00000000000000000000000000000000000000000000000000000000000000000000000000000000
00000000000000000000000000000000000000000000000000000000000000000000000000000000
00000000000000000000000000000000000000000000000000000000000000000000000000000000
00000000000000000000000000000000000000000000000000000000000000000000000000000000
00000000000000000000000000000000000000000000000000000000000000000000000000000000
00000000000000000000000000000000000000000000000000000000000000000000000000000000
00000000000000000000000000000000000000000000000000000000000000000000000000000000
00000000000000000000000000000000000000000000000000000000000000000000000000000000
00000000000000000000000000000000000000000000000000000000000000000000000000000000
00000000000000000000000000000000000000000000000000000000000000000000000000000000
00000000000000000000000000000000000000000000000000000000000000000000000000000000
