80 80
00000000000000000000000000000000000000000000000000000000000000000000000000000000
00001100000110011100000000000000000000000000000000000000000000000000000000000000
00001000000011111000000000000000000000000000000000000000000000000000000000000000
00011100010001110000000000000000000000000000000000000000000000000000000000000000
01111100011100111000100000000000000000000000000000000000000000000000000000000000
01111110011111111100100000000000000000000000000000000000000000000000000000000000
01111111111111101100110000000000000000000000000000000000000000000000000000000000
01111111110111000110111000001000000000000000000000000000000000000000000000000000
01111111000001001110011000011110000000000000000000000000000000000000000000000000
01111111001001111111111001110110000000000000000000000000000000000000000000000000
01111110001000111111111111100110000000000000000000000000000000000000000000000000
01111110001001111111111111000011000000000000000000000000000000000000000000000000
01111100001111111111111111100000000000000000000000000000000000000000000000000000
01111111110000011111111111100000000000000000000000000000000000000000000000000000
01111111110000011111121111111100000000000000000000000000000000000000000000000000
01111110001000111111111111100111000000000000000000000000000000000000000000000000
01111100001100111111111111100001000000000000000000000000000000000000000000000000
01110000001111110111111111100000000000000000000000000000000000000000000000000000
01110001111111111111111111000000000000000000000000000000000000000000000000000000
01110110011111111111101111000000000000000000000000000000000000000000000000000000
01111110011111111111111111000000000000000000000000000000000000000000000000000000
00010000011111111001111101100000000000000000000000000000000000000000000000000000
00000000001111110001111001000000000000000000000000000000000000000000000000000000
00000000000000000011111000000000000000000000000000000000000000000000000000000000
00000000000000110111111011000000000000000000000000000000000000000000000000000000
00000000000000011111111011000000000000000000000000000000000000000000000000000000
00000000000000000111100001000000000000000000000000000000000000000000000000000000
00000000000000000110000011000000000000000000000000000000000000000000000000000000
00000000000000000010000011000000000000000000000000000000000000000000000000000000
00000000000000000111100111000000000000000000000000000000000000000000000000000000
00000000000000000001110011100000000000000000000000000000000000000000000000000000
00000000000000000001110001100000000000000000000000000000000000000000000000000000
00000000000000000011111111110000000000000000000000000000000000000000000000000000
00000000000000000001110111111000000000000000000000000000000000000000000000000000
00000000000000000000110011011000000000000000000000000000000000000000000000000000
00000000000000000000100011100000000000000000000000000000000000000000000000000000
00000000000000000001100000100000000000000000000000000000000000000000000000000000
00000000000000000001000000000000000000000000000000000000000000000000000000000000
00000000000000000000000000000000000000000000000000000000000000000000000000000000
00000000000000000000000000000000000000000000000000000000000000000000000000000000
00000000000000000000000000000000000000000000000000000000000000000000000000000000
00000000000000000000000000000000000000000000000000000000000000000000000000000000
00000000000000000000000000000000000000000000000000000000000000000000000000000000
00000000000000000000000000000000000000000000000000000000000000000000000000000000
00000000000000000000000000000000000000000000000000000000000000000000000000000000
00000000000000000000000000000000000000000000000000000000000000000000000000000000
00000000000000000000000000000000000000000000000000000000000000000000000000000000
00000000000000000000000000000000000000000000000000000000000000000000000000000000
00000000000000000000000000000000000000000000000000000000000000000000000000000000
00000000000000000000000000000000000000000000000000000000000000000000000000000000
00000000000000000000000000000000000000000000000000000000000000000000000000000000
00000000000000000000000000000000000000000000000000000000000000000000000000000000
00000000000000000000000000000000000000000000000000000000000000000000000000000000
00000000000000000000000000000000000000000000000000000000000000000000000000000000
00000000000000000000000000000000000000000000000000000000000000000000000000000000
00000000000000000000000000000000000000000000000000000000000000000000000000000000
00000000000000000000000000000000000000000000000000000000000000000000000000000000
00000000000000000000000000000000000000000000000000000000000000000000000000000000
00000000000000000000000000000000000000000000000000000000000000000000000000000000
00000000000000000000000000000000000000000000000000000000000000000000000000000000
00000000000000000000000000000000000000000000000000000000000000000000000000000000
00000000000000000000000000000000000000000000000000000000000000000000000000000000
00000000000000000000000000000000000000000000000000000000000000000000000000000000
00000000000000000000000000000000000000000000000000000000000000000000000000000000
00000000000000000000000000000000000000000000000000000000000000000000000000000000
00000000000000000000000000000000000000000000000000000000000000000000000000000000
00000000000000000000000000000000000000000000000000000000000000000000000000000000
00000000000000000000000000000000000000000000000000000000000000000000000000000000
00000000000000000000000000000000000000000000000000000000000000000000000000000000
00000000000000000000000000000000000000000000000000000000000000000000000000000000
00000000000000000000000000000000000000000000000000000000000000000000000000000000
00000000000000000000000000000000000000000000000000000000000000000000000000000000
00000000000000000000000000000000000000000000000000000000000000000000000000000000
00000000000000000000000000000000000000000000000000000000000000000000000000000000
00000000000000000000000000000000000000000000000000000000000000000000000000000000
00000000000000000000000000000000000000000000000000000000000000000000000000000000
00000000000000000000000000000000000000000000000000000000000000000000000000000000
00000000000000000000000000000000000000000000000000000000000000000000000000000000
00000000000000000000000000000000000000000000000000000000000000000000000000000000
00000000000000000000000000000000000000000000000000000000000000000000000000000000
