80 80
00000000000000000000000000000000000000000000000000000000000000000000000000000000
00000000000000000000000000000000000000000000000000000000000000000000000000000000
00000000000000000000000000000000000000000000000000000000000000000000000000000000
00000000000000000000000000000000000000000000000000000000000000000000000000000000
00000000000000000000000000000000000000000000000000000000000000000000000000000000
00000000000000000000000000000000000000000000000000000000000000000000000000000000
00000000000000000000000000000000000000000000000000000000000000000000000000000000
00000000000000000000000000000000000000000000000000000000000000000000000000000000
00000000000000000000000000000000000000000000000000000000000000000000000000000000
00000000000000000000000000000000000000000000000000000000000000000000000000000000
00000000000000000000000000000000000000000000000000000000000000000000000000000000
00000000000000000000000000000000000000000000000000000000000000000000000000000000
00000000000000000000000000000000000000000000000000000000000000000000000000000000
00000000000000000000000000000000000000000000000000000000000000000000000000000000
00000000000000000000000000000000000000000000000000000000000000000000000000000000
00000000000000000000000000000000000000000000000000000000000000000000000000000000
00000000000000000000000000000000000000000000000000000000000000000000000000000000
00000000000000000000000000000000000000000000000000000000000000000000000000000000
00000000000000000000000000000000000000000000000000000000000000000000000000000000
00000000000000000000000000000000000000000000000000000000000000000000000000000000
00000000000000000000000000000000000000000000000000000000000000000000000000000000
00000000000000000000000000000000000000000000000000000000000000000000000000000000
00000000000000000000000000000000000000000000000000000000000000000000000000000000
00000000000000000000000000000000000000000000000000000000000000000000000000000000
00000000000000000000000000000000000000000000000000000000000000000000000000000000
00000000000000000000000000000000000000000000000000000000000000000000000000000000
00000000000000000000000000000000000000000000000000000000000000000000000000000000
00000000000000000000000000000000000000000000000000000000000000000000000000000000
00000000000000000000000000000000000000000000000000000000000000000000000000000000
00000000000000000000000000000000000000000000000000000000000000000000000000000000
00000000000000000000000000000000000000000000000000000000000000000000000000000000
00000000000000000000000000000000000000000000000000000000000000000000000000000000
00000000000000000000000000000000000000000000000000000000000000000000000000000000
00000000000000000000000000000000000000000000000000000000000000000000000000000000
00000000000000000000000000000000000000000000000000000000000000000000000000000000
00000000000000000000000000000000000000000000000000000000000000000000000000000000
00000000000000000000000000000000000000000000000000000000000000000000000000000000
00000000000000000000001000000000000000000000000000000000000000000000000000000000
00000000000000000000001110000000000000000000000000000000000000000000000000000000
00000000000000000000011111000000000000000000000000000000000000000000000000000000
00000000000000000011111011000000000000000000000000000000000000000000000000000000
00000000000000000011000001100000000000000000000000000000000000000000000000000000
00000000000000000100000111000000000000000000000000000000000000000000000000000000
00000000000000000100000011000000000000000000000000000000000000000000000000000000
00000000011000011110100001100000000000000000000000000000000000000000000000000000
00000000001000011111100001000000000000000000000000000000000000000000000000000000
00000000001100010011100001000000000000000000000000000000000000000000000000000000
00000000000100110010100011000000000000000000000000000000000000000000000000000000
00000000000100100000100011111000000000000000000000000000000000000000000000000000
00000000001100110100111111111011000100110000000000000000000000000000000000000000
00000000011100111101111111111111001111111000000000000000000000000000000000000000
00000000011000011111111111111111111111000000000000000000000000000000000000000000
00000000011100001111100111111100011111100000000000000000000000000000000000000000
00000000111110011000000111111110011100111100000000000000000000000000000000000000
00001000111110011000111011111111111100001110000000000000000000000000000000000000
00001111111110110001111111121111111100001110000000000000000000000000000000000000
00000011001111110001111111111111111100011100000000000000000000000000000000000000
00000000001111100000001111101111111100011110000000000000000000000000000000000000
00000000001100000100001111100011111100111010000000000000000000000000000000000000
00000000001000001100110011100011001101111000000000000000000000000000000000000000
00000000001000111001110011100111001111111100000000000000000000000000000000000000
00000000001111100001100011100110000111001110000000000000000000000000000000000000
00000000000110000000100001111111001111000110000000000000000000000000000000000000
00000000000000001110111000111111111111000110000000000000000000000000000000000000
00000000000000001011111001111111111110011100000000000000000000000000000000000000
00000000000000000001111111111111111111011100000000000000000000000000000000000000
00000000000000000001111111001111111111111100000000000000000000000000000000000000
00000000000000000000000000000111000001100000000000000000000000000000000000000000
00000000000000000000000000000110000001000000000000000000000000000000000000000000
00000000000000000000010000111111000110000000000000000000000000000000000000000000
00000000000000000001111111111111111110000000000000000000000000000000000000000000
00000000000000000001000010001111111100000000000000000000000000000000000000000000
00000000000000000000000000000111111111000000000000000000000000000000000000000000
00000000000000000000000000000100001111000000000000000000000000000000000000000000
00000000000000000000000000000000001100000000000000000000000000000000000000000000
00000000000000000000000000000000001110000000000000000000000000000000000000000000
00000000000000000000000000000000000010000000000000000000000000000000000000000000
00000000000000000000000000000000000000000000000000000000000000000000000000000000
00000000000000000000000000000000000000000000000000000000000000000000000000000000
00000000000000000000000000000000000000000000000000000000000000000000000000000000
