80 80
00000000000000000000000000000000000000000000000000000000000000000000000000000000
00000000000000011000111111111110111111000111111111100000111110001110011000000000
00000000000000011001101111001000011110000011111111100000011100001211010001000000
00000000000000001001101111000000001110000110111111110000011100011111110001000000
00000000000000001001101111000011011111001100011010111101100111111111111001001100
00000000001111111001111111101111111111111000011011111111100111111111111111111000
00000000000011100000111001111101110011111000011011111111000011111111101111110000
00000000001111100001111000010000010000000000000001111100000011001111100111110000
00000000011000110000001100000001110000000000000000111100000111000011100000011100
00000000001000010000011111000011000000000000000000110111000111001111111000011110
00000000001000011011111111100010000000000000000000100011100111001111111111111110
00000000000000010011001111100110000000000000000001100001111111011111111111100110
00000000000000110110001111000110000100000000000011100000011111110000111111000000
00000000000011110000001110000110001110000000000111111110001111110000111110000000
00000000000110110011111110000110011100000000001100110011000111111011111111100000
00000000001100111111111111100011011110000001111000100001101111111111111111111000
00000000000000011111110000110111110000000000000000000001111111111111111010011100
00000000000000111000000000000000100000000000000000000000011000111100000011000000
00000000000000011000000000000000000000000000000000000000000000111110000011000000
00000000000000011000000000000000000000000000000000001001110011111110000111111100
00000000000000010000000000000000000000000000000000101101111110011110011101111100
00000000000000000000000000000000000000000000000000100111011110000000110000110000
00000000000000000000000000000000000000000000000000101111010010000001100000000000
00000000000000000000000000000000000000000000000001101100000010000001100000000000
00000000000000000000000000000000000000000000000001111110000010000111110011000000
00000000000000000000000000000000000000000000000001111011100010000100111111000000
00000000000000000000000000000000000000000000000000000000111100000100100110000000
00000000000000000000000000000000000000000000000000000000001000000000000000000000
00000000000000000000000000000000000000000000000000000000000000000000000000000000
00000000000000000000000000000000000000000000000000000000000000000000000000000000
00000000000000000000000000000000000000000000000000000000000000000000000000000000
00000000000000000000000000000000000000000000000000000000000000000000000000000000
00000000000000000000000000000000000000000000000000000000000000000000000000000000
00000000000000000000000000000000000000000000000000000000000000000000000000000000
00000000000000000000000000000000000000000000000000000000000000000000000000000000
00000000000000000000000000000000000000000000000000000000000000000000000000000000
00000000000000000000000000000000000000000000000000000000000000000000000000000000
00000000000000000000000000000000000000000000000000000000000000000000000000000000
00000000000000000000000000000000000000000000000000000000000000000000000000000000
00000000000000000000000000000000000000000000000000000000000000000000000000000000
00000000000000000000000000000000000000000000000000000000000000000000000000000000
00000000000000000000000000000000000000000000000000000000000000000000000000000000
00000000000000000000000000000000000000000000000000000000000000000000000000000000
00000000000000000000000000000000000000000000000000000000000000000000000000000000
00000000000000000000000000000000000000000000000000000000000000000000000000000000
00000000000000000000000000000000000000000000000000000000000000000000000000000000
00000000000000000000000000000000000000000000000000000000000000000000000000000000
00000000000000000000000000000000000000000000000000000000000000000000000000000000
00000000000000000000000000000000000000000000000000000000000000000000000000000000
00000000000000000000000000000000000000000000000000000000000000000000000000000000
00000000000000000000000000000000000000000000000000000000000000000000000000000000
00000000000000000000000000000000000000000000000000000000000000000000000000000000
00000000000000000000000000000000000000000000000000000000000000000000000000000000
00000000000000000000000000000000000000000000000000000000000000000000000000000000
00000000000000000000000000000000000000000000000000000000000000000000000000000000
00000000000000000000000000000000000000000000000000000000000000000000000000000000
00000000000000000000000000000000000000000000000000000000000000000000000000000000
00000000000000000000000000000000000000000000000000000000000000000000000000000000
00000000000000000000000000000000000000000000000000000000000000000000000000000000
00000000000000000000000000000000000000000000000000000000000000000000000000000000
00000000000000000000000000000000000000000000000000000000000000000000000000000000
00000000000000000000000000000000000000000000000000000000000000000000000000000000
00000000000000000000000000000000000000000000000000000000000000000000000000000000
00000000000000000000000000000000000000000000000000000000000000000000000000000000
00000000000000000000000000000000000000000000000000000000000000000000000000000000
00000000000000000000000000000000000000000000000000000000000000000000000000000000
00000000000000000000000000000000000000000000000000000000000000000000000000000000
00000000000000000000000000000000000000000000000000000000000000000000000000000000
00000000000000000000000000000000000000000000000000000000000000000000000000000000
00000000000000000000000000000000000000000000000000000000000000000000000000000000
00000000000000000000000000000000000000000000000000000000000000000000000000000000
00000000000000000000000000000000000000000000000000000000000000000000000000000000
00000000000000000000000000000000000000000000000000000000000000000000000000000000
00000000000000000000000000000000000000000000000000000000000000000000000000000000
00000000000000000000000000000000000000000000000000000000000000000000000000000000
00000000000000000000000000000000000000000000000000000000000000000000000000000000
00000000000000000000000000000000000000000000000000000000000000000000000000000000
00000000000000000000000000000000000000000000000000000000000000000000000000000000
00000000000000000000000000000000000000000000000000000000000000000000000000000000
00000000000000000000000000000000000000000000000000000000000000000000000000000000
