80 80
00000000000000000000000000000000000000000000000000000000000000000000000000000000
00000000000000000000000000000000000000000000000000000000000000000000000000000000
00000000000000000000000000000000000000000000000000000000000000000000000000000000
00000000000000000000000000000000000000000000000000000000000000000000000000000000
00000000000000000000000000000000000000000000000000000000000000000000000000000000
00000000000000000000000000000000000000000000000000000000000000000000000000000000
00000000000000000000000000000000000000000000000000000000000000000000000000000000
00000000000000000000000000000000000000000000000000000000000000000000000000000000
00000000000000000000000000000000000000000000000000000000000000000000000000000000
00000000000000000000000000000000000000000000000000000000000000000000000000000000
00000000000000010000000000000000000000000000000000000000000000000000000000000000
00000000000000011000000000000000000000000000000000000000000000000000000000000000
00000000000000001100000000000000000000000000000000000000000000000000000000000000
00000000000000000100000000000000000000000000000000000000000000000000000000000000
00000000000001100110100000000000000000000000000000000000000000000000000000000000
00000000011111111111100011100000000000000000000000000000000000000000000000000000
00000000001100011101100011000000000000000000000000000000000000000000000000000000
00000000001110000001100010000000000000000000000000000000000000000000000000000000
00000001011100100001100010000000000000000000000000000000000000000000000000000000
00000001111000110000110011000000000000000000000000000000000000000000000000000000
00011111111100010000100011100000000000000000000000000000000000000000000000000000
00011000001100110001100011100000000000000000000000000000000000000000000000000000
01111000000011111011110011100000000000000000000000000000000000000000000000000000
01110110011001111111111111000000000000000000000000000000000000000000000000000000
01111111111100111001111111100100000000000000000000000000000000000000000000000000
01111110111110111001111111111111000000000000000000000000000000000000000000000000
01111100011110110001111111100001000000000000000000000000000000000000000000000000
01111000011111110001111111110000000000000000000000000000000000000000000000000000
01110011111000110001111111000000000000000000000000000000000000000000000000000000
00011111111100111011111111100000000000000000000000000000000000000000000000000000
00011111111100111011111111110000000000000000000000000000000000000000000000000000
00111110001110111111111111110000000000000000000000000000000000000000000000000000
01111100000011111111001111110000000000000000000000000000000000000000000000000000
01111000000001111111001111100000000000000000000000000000000000000000000000000000
01111111111001111111111111100001000000000000000000000000000000000000000000000000
01111111111111111111111111100111000000000000000000000000000000000000000000000000
01111111001111111111111111111100000000000000000000000000000000000000000000000000
00000000000111111111111111100000000000000000000000000000000000000000000000000000
00000000001111111111110111100000000000000000000000000000000000000000000000000000
00011100001111111111110011110001100000000000000000000000000000000000000000000000
01111111011111111111111111110111100000000000000000000000000000000000000000000000
01110111111111121111111111111110000000000000000000000000000000000000000000000000
01110011111111111111111100011110000000000000000000000000000000000000000000000000
01111100111111111111101100111111100000000000000000000000000000000000000000000000
00001100111111111111111111111111110000000000000000000000000000000000000000000000
00000110111111111111111111111111111100000000000000000000000000000000000000000000
00000111111111111001111111011111100000000000000000000000000000000000000000000000
00000111111111011100001110000000110000000000000000000000000000000000000000000000
00000101111110011111111110000000100000000000000000000000000000000000000000000000
01111100111111111111111111100001100100000000000000000000000000000000000000000000
01001111111111111111111111110111110100000000000000000000000000000000000000000000
00000111111111111111111111111110011100000000000000000000000000000000000000000000
00000001111111100111111111111000001000000000000000000000000000000000000000000000
01100001100111001111111111111100000000000000000000000000000000000000000000000000
01111111111111111111111111111111000000000000000000000000000000000000000000000000
01011111111111111111111111111111100000000000000000000000000000000000000000000000
00001111111111111111111111111111000000000000000000000000000000000000000000000000
01011111000011100001111100001111000000000000000000000000000000000000000000000000
01111111000111100001111100001110011100000000000000000000000000000000000000000000
01111111011111111001111111000111111110000000000000000000000000000000000000000000
01111111111111111111111111110111111110000000000000000000000000000000000000000000
00111111111111111111111111111111111110000000000000000000000000000000000000000000
01111111111111111111111100111111111110000000000000000000000000000000000000000000
01100111011111111111111100111111110000000000000000000000000000000000000000000000
01000110011111111111111111111111111100000000000000000000000000000000000000000000
00001111111111111111111111111111111111111000000000000000000000000000000000000000
00001100011111111111111111111111110011110000000000000000000000000000000000000000
01110000000011111111111111111111100000110000000000000000000000000000000000000000
00011111000111111111111111111111111000010000000000000000000000000000000000000000
00001111011111111111111111111111111100011110000000000000000000000000000000000000
00011111111111111111111111111111101110011110000000000000000000000000000000000000
00011111111111111111111111111111000111001100000000000000000000000000000000000000
00001111111011111111111011111111001111000000000000000000000000000000000000000000
00001111111001111110111111111111111111100000000000000000000000000000000000000000
00000110111111111111111111100111111100110000000000000000000000000000000000000000
00000100011111111111111111100111111110011100000000000000000000000000000000000000
00000100001111111111111111100111111110000100000000000000000000000000000000000000
00000000000111111111101111111111110011000000000000000000000000000000000000000000
00000000000111111000111111111111110001100000000000000000000000000000000000000000
00000000000000000000000000000000000000000000000000000000000000000000000000000000
