80 80
00000000000000000000000000000000000000000000000000000000000000000000000000000000
00000000000000000000000000000000000000000000000000000000000000000000000000000000
00000000000000000000000000000000000000000000000000000000000000000000000000000000
00000000000000000000000000000000000000000000000000000000000000000000000000000000
00000000000000000000000000000000000000000000000000000000000000000000000000000000
00000000000000000000000000000000000000000000000000000000000000000000000000000000
00000000000000000000000000000000000000000000000000000000000000000000000000000000
00000000000000000000000000000000000000000000000000000000000000000000000000000000
00000000000000000000000000000000000000000000000000000000000000000000000000000000
00000000000000000000000000000000000000000000000000000000000000000000000000000000
00000000000000000000000000000000000000000000000000000000000000000000000000000000
00000000000000000000000000000000000000000000000000000000000000000000000000000000
00000000000000000000000000000000000000000000000000000000000000000000000000000000
00000000000000000000000000000000000000000000000000000000000000000000000000000000
00000000000000000000000000000000000000000000000000000000000000000000000000000000
00000000000000000000000000000000000000000000000000000000000000000000000000000000
00000000000000000000000000000000000000000000000000000000000000000000000000000000
00000000000000000000000000000000000000000000000000000000000000000000000000000000
00000000000000000000000000000000000000000000000000000000000000000000000000000000
00000000000000000000000000000000000000000000000000000000000000000000000000000000
00000000000000000000000000000000000000000000000000000000000000000000000000000000
00000000000000000000000000000000000000000000000000000000000000000000000000000000
00000000000000000000000000000000000000000000000000000000000000000000000000000000
00000000000000000000000000000000000000000000000000000000000000000000000000000000
00000000000000000000000000000000000000000000000000000000000000000000000000000000
00000000000000000000000000000000000000000000000000000000000000000000000000000000
00000000000000000000000000000000000000000000000000000000000000000000000000000000
00000000000000000000000000000000000000000000000000000000000000000000000000000000
00000000000000000000000000000000000000000000000000000000000000000000000000000000
00000000000000000000000000000000000000000000000000000000000000000000000000000000
00000000000000000000000000000000000000000000000000000000000000000000000000000000
00000000000000000000000000000000000000000000000000000000000000000000000000000000
00000000000000000000000000000000000000000000000000000000000000000000000000000000
00000000000000000000000000000000000000000000000000000000000000000000001100000000
00000000000000000000000000000000000000000000000000000000000000000000001100000000
00000000000000000000000000000000000000000000000000000000000000001111111100011000
00000000000000000000000000000000000000000000000000000000000000001001111000011000
00000000000000000000000000000000000000000000000000000000000000000000111000011100
00000000000000000000000000000000000000000000000000000000000000000000111100110000
00000000000000000000000000000000000000000000000000000000000010000001101111110000
00000000000000000000000000000000000000000000000000000000000010001111111111111110
00000000000000000000000000000000000000000000000000000000000010000000111011111110
00000000000000000000000000000000000000000000000000000000000110000001110011111110
00000000000000000000000000000000000000000000000000000000001100000011000111111110
00000000000000000000000000000000000000000000000000000000001100000110001111111110
00000000000000000000000000000000000000000000000000000000001111001110011100111110
00000000000000000000000000000000000000000000000000000000000001111100011000111110
00000000000000000000000000000000000000000000000000000000000000011000110000111110
00000000000000000000000000000000000000000000000000000000011000000000110000011110
00000000000000000000000000000000000000000000000000000000111110000111111000011110
00000000000000000000000000000000000000000000000000000011111111001111111100111010
00000000000000000000000000000000000000000000000000001110011111001111111100110000
00000000000000000000000000000000000000000000000000000000001111001001100111110010
00000000000000000000000000000000000000000000000000000000001110001001100111100010
00000000000000000000000000000000000000000000000011000000011110001111111111110110
00000000000000000000000000000000000000000000000001111111111110001111111100111110
00000000000000000000000000000000000000000000000000000001110011001111111100011110
00000000000000000000000000000000000000000000000000000000111111101111111100001110
00000000000000000000000000000000000000000000000000000001111111111110001100001110
00000000000000000000000000000000000000000000000000000011111111111110001100011110
00000000000000000000000000000000000000000000000000000011111211101110011100111110
00000000000000000000000000000000000000000000000000000011111111001111111101111110
00000000000000000000000000000000000000000000000000000000011111000111111111000100
00000000000000000000000000000000000000000000000000000000011111000000110000000100
00000000000000000000000000000000000000000000000000000000111111111100011000011100
00000000000000000000000000000000000000000000000000000111110111111110011110111000
00000000000000000000000000000000000000000000000000000110000110110110000111110000
00000000000000000000000000000000000000000000000000000100001100100010000000110010
00000000000000000000000000000000000000000000000000000100001000000110000000111110
00000000000000000000000000000000000000000000000000000011011011001110000000111000
00000000000000000000000000000000000000000000000000000001111111001110011100111000
00000000000000000000000000000000000000000000000000000001111111001111110000011000
00000000000000000000000000000000000000000000000000000011111111111111100000001100
00000000000000000000000000000000000000000000000000001111001110011111110000001100
00000000000000000000000000000000000000000000000000011011001110001111111101011100
00000000000000000000000000000000000000000000000000000001100111001111111111111110
00000000000000000000000000000000000000000000000000000001100011111111111111110110
00000000000000000000000000000000000000000000000000000001100000011111111111100000
00000000000000000000000000000000000000000000000000000011111000011100011111110000
00000000000000000000000000000000000000000000000000000000000000000000000000000000
