80 80
00000000000000000000000000000000000000000000000000000000000000000000000000000000
00000000111100011000000000001100000000000000000000000000000011001111111111111000
00000000111111111000000000001000000000000000000000000000000001111111111111111110
00000000011111011000000100011000000000000000000000000010000000111111111111111110
00000000011011111110001111011011000110000000000000000011000000011111111111111110
00000000011111111111111111111111111100000000000000000011000111111111112111111110
00000011001111111000111001111111111100000000000000000001100000111111111111111110
00000001111011110000001001110000000000000000000000000011110000011111111111111110
00000000110011110000011111100000000000000000000000000111110000111111111111111110
00000100011011010000110011101100011100000000000001100111111111111111111111111110
00000100011111110001110011111111101111000000000000111111100111111111111111111110
01110100001111110001110001111011000110000000000000111110000111111101111110011110
00110110001110000011100000000000001110000000000000001000000111100000111110000110
01110011111101100111110000000110111110000000000110001100000111100000111111000010
01111111111000110111111111011111111111000100011111111110000111101111011111111110
01001111111100111111111111111111111111111111111011111111111111111111011101111110
01000111001100011111111111111111000111111011110001111000111111111111011000111110
00000010001100000111111110011100000000110000000001110000001111111000001100100000
00001111111100000111111110001100000000011000000010000000000111111000001111100000
00001111111111111111111111000110011100011000001111111111100011111100001100110000
01001111111111111111111111100111111110001000111111111111110011111100011100010000
01100111111110011111111101100011101111001101110111000111110110000000000000010000
01100011111111001111111000100000000111111111100000000000000010000000000000000000
01100011101111110011111000011000000111111111110000010000000011000000000000000000
01111111001111111011111000111110001111111111111111110000000011000000000000000000
01111111011111111011111111110111001111111111111111111111100010000000000000000000
01111110111011111111111110001111000111111011110111111100110110000000000000000000
01111000110011111111000000001111000000100001100110111000010111000000000000000000
01111000110011111011000000000000000000100001000010111000000010000000000000000000
01111110011110110011100000100000000000110011110001110001000010000000000000000000
01111110011100010001111111100000000000111111111001110001000010000000000000000000
01111110011100011000011110000000000000000000111001110011000010000000000000000000
01111110010000011000000000000000000000000000000000000111000011000000000000000000
01101100110000100000000000000000000000000000000000001111111110000000000000000000
01001101111111110000000000000000000000000000000000001101100000000000000000000000
01000111111111110000000000000000000000000000000001111111100000000000000000000000
00000111001000000000000000000000000000000000000001000110000000000000000000000000
01000111000000000000000000000000000000000000000001000000000000000000000000000000
01111110000000000000000000000000000000000000000001000000000000000000000000000000
00000100000000000000000000000000000000000000000000000000000000000000000000000000
00000100000000000000000000000000000000000000000000000000000000000000000000000000
00000000000000000000000000000000000000000000000000000000000000000000000000000000
00000000000000000000000000000000000000000000000000000000000000000000000000000000
00000000000000000000000000000000000000000000000000000000000000000000000000000000
00000000000000000000000000000000000000000000000000000000000000000000000000000000
00000000000000000000000000000000000000000000000000000000000000000000000000000000
00000000000000000000000000000000000000000000000000000000000000000000000000000000
00000000000000000000000000000000000000000000000000000000000000000000000000000000
00000000000000000000000000000000000000000000000000000000000000000000000000000000
00000000000000000000000000000000000000000000000000000000000000000000000000000000
00000000000000000000000000000000000000000000000000000000000000000000000000000000
00000000000000000000000000000000000000000000000000000000000000000000000000000000
00000000000000000000000000000000000000000000000000000000000000000000000000000000
00000000000000000000000000000000000000000000000000000000000000000000000000000000
00000000000000000000000000000000000000000000000000000000000000000000000000000000
00000000000000000000000000000000000000000000000000000000000000000000000000000000
00000000000000000000000000000000000000000000000000000000000000000000000000000000
00000000000000000000000000000000000000000000000000000000000000000000000000000000
00000000000000000000000000000000000000000000000000000000000000000000000000000000
00000000000000000000000000000000000000000000000000000000000000000000000000000000
00000000000000000000000000000000000000000000000000000000000000000000000000000000
00000000000000000000000000000000000000000000000000000000000000000000000000000000
00000000000000000000000000000000000000000000000000000000000000000000000000000000
00000000000000000000000000000000000000000000000000000000000000000000000000000000
00000000000000000000000000000000000000000000000000000000000000000000000000000000
00000000000000000000000000000000000000000000000000000000000000000000000000000000
00000000000000000000000000000000000000000000000000000000000000000000000000000000
00000000000000000000000000000000000000000000000000000000000000000000000000000000
00000000000000000000000000000000000000000000000000000000000000000000000000000000
00000000000000000000000000000000000000000000000000000000000000000000000000000000
00000000000000000000000000000000000000000000000000000000000000000000000000000000
00000000000000000000000000000000000000000000000000000000000000000000000000000000
00000000000000000000000000000000000000000000000000000000000000000000000000000000
00000000000000000000000000000000000000000000000000000000000000000000000000000000
00000000000000000000000000000000000000000000000000000000000000000000000000000000
00000000000000000000000000000000000000000000000000000000000000000000000000000000
00000000000000000000000000000000000000000000000000000000000000000000000000000000
00000000000000000000000000000000000000000000000000000000000000000000000000000000
00000000000000000000000000000000000000000000000000000000000000000000000000000000
00000000000000000000000000000000000000000000000000000000000000000000000000000000
