80 80
00000000000000000000000000000000000000000000000000000000000000000000000000000000
00000000000000000000000000000000000000000000000000000000000000000000000000000000
00000000000000000000000000000000000000000000000000000000000000000000000000000000
00000000000000000000000000000000000000000000000000000000000000000000000000000000
00000000000000000000000000000000000000000000000000000000000000000000000000000000
00000000000000000000000000000000000000000000000000000000000000000000000000000000
00000000000000000000000000000000000000000000000000000000000000000000000000000000
00000000000000000000000000000000000000000000000000000000000000000000000000000000
00000000000000000000000000000000000000000000000000000000000000000000000000000000
00000000000000000000000000000000000000000000000000000000000000000000000000000000
00000000000000000000000000000000000000000000000000000000000000000000000000000000
00000000000000000000000000000000000000000000000000000000000000000000000000000000
00000000000000000000000000000000000000000000000000000000000000000000000000000000
00000000000000000000000000000000000000000000000000000000000000000000000000000000
00000000000000000000000000000000000000000000000000000000000000000000000000000000
00000000000000000000000000000000000000000000000000000000000000000000000000000000
00000000000000000000000000000000000000000000000000000000000000000000000000000000
00000000000000000000000000000000000000000000000000000000000000000000000000000000
00000000000000000000000000000000000000000000000000000000000000000000000000000000
00000000000000000000000000000000000000000000000000000000000000000000000000000000
00000000000000000000000000000000000000000000000000000000000000000000000000000000
00000000000000000000000000000000000000000000000000000000000000000000000000000000
00000000000000000000000000000000000000000000000000000000000000000000000000000000
00000000000000000000000000000000000000000000000000000000000000000000000000000000
00000000000000000000000000000000000000000000000000000000000000000000000000110010
00000000000000000000000000000000000000000000000000000000000000000000000000011110
00000000000000000000000000000000000000000000000000000000000000000000000000011100
00000000000000000000000000000000000000000000000000000000000000000000000000011000
00000000000000000000000000000000000000000000000000000000000000000000000000011000
00000000000000000000000000000000000000000000000000000000000000000000001000011000
00000000000000000000000000000000000000000000000000000000000000000000001000010000
00000000000000000000000000000000000000000000000000000000000000100000111000110000
00000000000000000000000000000000000000000000000000000000000111100000110000110000
00000000000000000000000000000000000000000000000000000111000111000000110000111100
00000000000000000000000000000000000000000000000000011111111110000111111000111110
00000000000000000000000000000000000000000000000001110011111111001111111000111110
00000000000000000000000000000000000000000000000001100011111000111101101111111100
00000000000000000000000000000000000000000000000000110001010000000001100111011000
00000000000000000000000000000000000000000000000000110001011000000001110011000000
00000000000000000000000000000000000000000000011101100001111110000111111111001000
00000000000000000000000000000000000000000000111111110011100111001111111111111100
00000000000000000000000000000000000000000000100110000011000011101111111111100110
00000000000000000000000000000000000000000000000000000011100001101111110000000000
00000000000000000000000000000000000000000000000000000001111000101111110000000000
00000000000000000000000000000000000000000000000000000011111111111110011111100000
00000000000000000000000000000000000000000000000000000011111111111110111111111000
00000000000000000000000000000000000000000000000000000011111111111100111110011100
00000000000000000000000000000000000000000000000000000000011111110000100100001110
00000000000000000000000000000000000000000000000000000000011011110001111110010010
00000000000000000000000000000000000000000000000000000001111011111101111111110000
00000000000000000000000000000000000000000000000000000011111111111111111111111000
00000000000000000000000000000000000000000000000000000011110110111111111111011000
00000000000000000000000000000000000000000000000000000110010000010001111110000100
00000000000000000000000000000000000000000000000000011100110000011001112111000100
00000000000000000000000000000000000000000000000000110001100000001101111111111100
00000000000000000000000000000000000000000000000000100001000000001111111111111100
00000000000000000000000000000000000000000000000000100000000000000111111001111000
00000000000000000000000000000000000000000000000000000000000000000011100001111000
00000000000000000000000000000000000000000000000000000000000000000000000000111000
00000000000000000000000000000000000000000000000000000000000000000000000000111000
00000000000000000000000000000000000000000000000000000000000000000000000000010000
00000000000000000000000000000000000000000000000000000000000000000000000000110000
00000000000000000000000000000000000000000000000000000000000000000000000000000000
00000000000000000000000000000000000000000000000000000000000000000000000000000000
00000000000000000000000000000000000000000000000000000000000000000000000000000000
00000000000000000000000000000000000000000000000000000000000000000000000000000000
00000000000000000000000000000000000000000000000000000000000000000000000000000000
00000000000000000000000000000000000000000000000000000000000000000000000000000000
00000000000000000000000000000000000000000000000000000000000000000000000000000000
00000000000000000000000000000000000000000000000000000000000000000000000000000000
00000000000000000000000000000000000000000000000000000000000000000000000000000000
00000000000000000000000000000000000000000000000000000000000000000000000000000000
00000000000000000000000000000000000000000000000000000000000000000000000000000000
00000000000000000000000000000000000000000000000000000000000000000000000000000000
00000000000000000000000000000000000000000000000000000000000000000000000000000000
00000000000000000000000000000000000000000000000000000000000000000000000000000000
00000000000000000000000000000000000000000000000000000000000000000000000000000000
00000000000000000000000000000000000000000000000000000000000000000000000000000000
00000000000000000000000000000000000000000000000000000000000000000000000000000000
00000000000000000000000000000000000000000000000000000000000000000000000000000000
