80 80
00000000000000000000000000000000000000000000000000000000000000000000000000000000
00000000000000000000000000000000000000000000000000000000000000000000000000000000
00000000000000000000000000000000000000000000000000000000000000000000000000000000
00000000000000000000000000000000000000000000000000000000000000000000000000000000
00000000000000000000000000000000000000000000000000000000000000000000000000000000
00000000000000000000000000000000000000000000000000000000000000000000000000000000
00000000000000000000000000000000000000000000000000000000000000000000000000000000
00000000000000000000000000000000000000000000000000000000000000000000000000000000
00000000000000000000000000000000000000000000000000000000000000000000000000000000
00000000000000000000000000000000000000000000000000000000000000000000000000000000
00000000000000000000000000000000000000000000000000000000000000000000000000000000
00000000000000000000000000000000000000000000000000000000000000000000000000000000
00000000000000000000000000000000000000000000000000000000000000000000000000000000
00000000000000000000000000000000000000000000000000000000000000000000000000000000
00000000000000000000000000000000000000000000000000000000000000000000000000000000
00000000000000000000000000000000000000000000000000000000000000000000000000000000
00000000000000000000000000000000000000000000000000000000000000000000000000000000
00000000000000000000000000000000000000000000000000000000000000000000000000000000
00000000000000000000000000000000000000000000000000000000000000000000000000000000
00000000000000000000000000000000000000000000000000000000000000000000000000000000
00000000000000000000000000000000000000000000000000000000000000000000000000000000
00000000000000000000000000000000000000000000000000000000000000000000000000000000
00000000000000000000000000000000000000000000000000000000000000000000000000000000
00000000000000000000000000000000000000000000000000000000000000000000000000000000
00000000000000000000000000000000000000000000000000000000000000000000000000000000
00000000000000000000000000000000000000000000000000000000000000000000000000000000
00000000000000000000000000000000000000000000000000000000000000000000000000000000
00000000000000000000000000000000000000000000000000000000000000000000000000000000
00000000000000000000000000000000000000000000000000000000000000000000000000000000
00000000000000000000000000000000000000000000000000000000000000000000000000000000
00000000000000000000000000000000000000000000000000000000000000000000000000000000
00000000000000000000000000000000000000000000000000000000000000000000000000000000
00000000000000000000000000000000000000000000000000000000000000000000000000000000
00000000000000000000000000000000000000000000000011000000000000000000000000000000
00000000000000000000000000000000000000000000000001100000000000000000000000000000
00000000000000000000000000000000000000000000000001110000000000000000000000000000
00000000000000000000000000000000000000000000000000110000000000000000000000000000
00000000000000000000000000000000000000000000000001110000000000000000000000000000
00000000000000000000000000000000000000000000000000100000000000000000000000000000
00000000000000000000000000000000000000000000011000101100000000000000000000000000
00000000000000000000000000000000000000000000011101111111100000000000000000000000
00000000000000000000000000000000000000000000111110100000111000000000000000000000
00000000000000000000000000000000000000000000011110000000111000000000000000000000
00000000000000000000000000000000000000000000001100000001111110000000000000000000
00000000000000000000000000000000000000000000011100000001110010000000000000000000
00000000000000000000000000000000000111111001111000000011110010000000000000000000
00000000000000000000000000000000000000001001110000000001100010000000000000000000
00000000000000000000000000000000000000001001111000000001100000000000000000000000
00000000000000000000000000000000000000011001111110000111111000000000000000000000
00000000000000000000000000000000010000011001111111110111100000000000000000000000
00000000000000000000000000000000011111011100111111111111100000000000000000000000
00000000000000000000000000000000000001111100011111110111100000000000000000000000
00000000000000000000000000000000000000111110000110000111110000000000000000000000
00000000000000000001110000000001000000111111100011000101110000000000000000000000
00000010000000010001110000000011100000101100010001111111111010000000000000000000
00001110011111111011111000000111111111111100111001111111111110000000000000000000
00001100000011001111111000000111111111110000010000111011011110000000000000000000
00001000000011000000000000000000111110000000011000011110000011000000000000000000
00011000000011000000000000001000011110000000001110001110000000000000000000000000
00111100001111110000000000011100111111110001111111111111000000000000000000000000
01111100011111111000000000000111111110011111111111111111100000000000000000000000
01100111111011011110000000000001111100001110011111121111100000000000000000000000
01100011111011111010000000000000001100001100000111111110110000000000000000000000
01110000001111110001000000000000001100000000000011111100010000000000000000000000
01111100001111110011000001100001101100001100110011111110011000000000000000000000
01111100011111111111111011111111100100011100111111111111111111000000000000000000
00111110011011001000011111111100100110110000011111110000110000000000000000000000
00100111100001000000011111110000100011100000001000000000010000000000000000000000
01100111100001100000111111110000110001100000001000000000000000000000000000000000
01000111100111110000111111110001111001111000011000000000000000000000000000000000
01001111111111111000111111101111111111001000010000000000000000000000000000000000
01011100000001111000110001111110110011001000110000000000000000000000000000000000
00011000000001110000000000001110100000000000000000000000000000000000000000000000
00000000000001100000000000000111000000000000000000000000000000000000000000000000
00000111000111111000000000000111000010000000000000000000000000000000000000000000
00000100111111111111110000000111111110000000000000000000000000000000000000000000
00000100111000000111000000000111111000000000000000000000000000000000000000000000
00000111110000000000000000000000000000000000000000000000000000000000000000000000
00000000010000000000000000000000000000000000000000000000000000000000000000000000
00000000000000000000000000000000000000000000000000000000000000000000000000000000
