80 80
00000000000000000000000000000000000000000000000000000000000000000000000000000000
00000000000000000000000000000000000000000000000000000000000000000000000000000000
00000000000000000000000000000000000000000000000000000000000000000000000000000000
00000000000000000000000000000000000000000000000000000000000000000000000000000000
00000000000000000000000000000000000000000000000000000000000000000000000000000000
00000000000000000000000000000000000000000000000000000000000000000000000000000000
00000000000000000000000000000000000000000000000000000000000000000000000000000000
00000000000000000000000000000000000000000000000000000000000000000000000000000000
00000000000000000000000000000000000000000000000000000000000000000000000000000000
00000000000000000000000000000000000000000000000000000000000000000000000000000000
00000000000000000000000000000000000000000000000000000000000000000000000000000000
00000000000000000000000000000000000000000000000000000000000000000000000000000000
00000000000000000000000000000000000000000000000000000000000000000000000000000000
00000000000000000000000000000000000000000000000000000000000000000000000000000000
00000000000000000000000000000000000000000000000000000000000000000000000000000000
00000000000000000000000000000000000000000000000000000000000000000000000000000000
00000000000000000000000000000000000000000000000000000000000000000000000000000000
00000000000000000000000000000000000000000000000000000000000000000000000000000000
00000000001011000000000000000000000000000000000000000000000000000000000000000000
00000000011111111100000000000000000000000000000000000000000000000000000000000000
00000000011111111111100000000000000000000000000000000000000000000000000000000000
00000000011000111111000000000000000000000000000000000000000000000000000000000000
00000000000000111111100000000000000000000000000000000000000000000000000000000000
00000000000000011011110000000000000000000000000000000000000000000000000000000000
00011110001110010001100000000000000000000000000000000000000000000000000000000000
01111110011110010000100000000000000000000000000000000000000000000000000000000000
01111110111011010000110000000000000000000000000000000000000000000000000000000000
01111001101011110010100100000000000000000000000000000000000000000000000000000000
01111101100011110011111100000000000000000000000000000000000000000000000000000000
01111100110111110000111111100000000000000000000000000000000000000000000000000000
00001110111111111101111111100000000000000000000000000000000000000000000000000000
00000110000111111111100011000000000000000000000000000000000000000000000000000000
00000110000001111111110000000000000000000000000000000000000000000000000000000000
00001110000001111110011001100000000000000000000000000000000000000000000000000000
00000100001100111111111101000000000000000000000000000000000000000000000000000000
00000100001000111001111111000000000000000000000000000000000000000000000000000000
00001100011000111000111111000000000000000000000000000000000000000000000000000000
00011000110000111100000111000000000000000000000000000000000000000000000000000000
00010000100000111100000111000000000000000000000000000000000000000000000000000000
00110111110001111111111111100000000000000000000000000000000000000000000000000000
01111111111111111111111111100000000000000000000000000000000000000000000000000000
00111001100111111111111111100000000000000000000000000000000000000000000000000000
00010000000000001100000100100000000000000000000000000000000000000000000000000000
00000000000000001100001100111000000000000000000000000000000000000000000000000000
00000000001100111101111111111100000100000000000000000000000000000000000000000000
00001111111111111111111111100111000100000000000000000000000000000000000000000000
00000100111111111121111111000011000100000000000000000000000000000000000000000000
00011111111111111111111100000000000110000000000000000000000000000000000000000000
00000111111100111111110000000000000010000000000000000000000000000000000000000000
00000111111100011111100111000111110110000000000000000000000000000000000000000000
00000111111100111111111111111111111110000000000000000000000000000000000000000000
00000000110011111111111101100111111100000000000000000000000000000000000000000000
00000000000001100111111000001000110000000000000000000000000000000000000000000000
00000000000001100011111000011000110000000000000000000000000000000000000000000000
00000000000011110011111101111111110010000000000000000000000000000000000000000000
00000000001110111111111111100111111110000000000000000000000000000000000000000000
00000000000110010111111111000111111100000000000000000000000000000000000000000000
00000000000011000011111000000111111000000000000000000000000000000000000000000000
00000000000010000001111000001001111000000000000000000000000000000000000000000000
00000000000110000001110110011011101100000000000000000000000000000000000000000000
00000000000000000000110011111111000100000000000000000000000000000000000000000000
00000000000000000000100000011110000110000000000000000000000000000000000000000000
00000000000000000000000000001110000111100000000000000000000000000000000000000000
00000000000000000000000000000110011100000000000000000000000000000000000000000000
00000000000000000000000000000011001100000000000000000000000000000000000000000000
00000000000000000000000000000010000100000000000000000000000000000000000000000000
00000000000000000000000000000110000100000000000000000000000000000000000000000000
00000000000000000000000000001111111000000000000000000000000000000000000000000000
00000000000000000000000000000100000000000000000000000000000000000000000000000000
00000000000000000000000000000100000000000000000000000000000000000000000000000000
00000000000000000000000000000000000000000000000000000000000000000000000000000000
00000000000000000000000000000000000000000000000000000000000000000000000000000000
00000000000000000000000000000000000000000000000000000000000000000000000000000000
00000000000000000000000000000000000000000000000000000000000000000000000000000000
00000000000000000000000000000000000000000000000000000000000000000000000000000000
00000000000000000000000000000000000000000000000000000000000000000000000000000000
00000000000000000000000000000000000000000000000000000000000000000000000000000000
00000000000000000000000000000000000000000000000000000000000000000000000000000000
00000000000000000000000000000000000000000000000000000000000000000000000000000000
00000000000000000000000000000000000000000000000000000000000000000000000000000000
