80 80
00000000000000000000000000000000000000000000000000000000000000000000000000000000
00000000000000000000000000000000000000000000000000000000000000000000000000000000
00000000000000000000000000000000000000000000000000000000000000000000000000000000
00000000000000000000000000000000000000000000000000000000000000000000000000000000
00000000000000000000000000000000000000000000000000000000000000000000000000000000
00000000000000000000000000000000000000000000000000000000000000000000000000000000
00000000000000000000000000000000000000000000000000000000000000000000000000000000
00000000000000000000000000000000000000000000000000000000000000000000000000000000
00000000000000000000000000000000000000000000000000000000000000000000000000000000
00000000000000000000000000000000000000000000000000000000000000000000000000000000
00000000000000000000000000000000000000000000000000000000000000000000000000000000
00000000000000000000000000000000000000000000000000000000000000000000000000000000
00000000000000000000000000000000000000000000000000000000000000000000000000000000
00000000000000000000000000000000000000000000000000000000000000000000000000000000
00000000000000000000000000000000000000000000000000000000000000000000000000000000
00000000000000000000000000000000000000000000000000000000000000000000000000000000
00000000000000000000000000000000000000000000000000000000000000000000000000000000
00000000000000000000000000000000000000000000000000000000000000000000000000000000
00000000000000000000000000000000000000000000000000000000000000000000000000000000
00000000000000000000000000000000000000000000000000000000000000000111110010000000
00000000000000000000000000000000000000000000000000000000000000000100011110000000
00000000000000000000000000000000000000000000000000000000000000001100000100000000
00000000000000000000000000000000000000000000000000000000000001111000000110000000
00000000000000000000000000000000000000000000000000000001000000011100001100000000
00000000000000000000000000000000000000000000000000000001100010011110001000000000
00000000000000000000000000000000000000000000000000000001000010001110001000000000
00000000000000000000000000000000000000000000000000000011000010001111001000000000
00000000000000000000000000000000000000000000000000000001100111011100110000000000
00000000000000000000000000000000000000000000000000000001111111111000011000000000
00000000000000000000000000000000000000000000000000000001111111111100001001100000
00000000000000000000000000000000000000000000000000000011101111111110001011110000
00000000000000000000000000000000000000000000000000000011000111000111011011000000
00000000000000000000000000000000000000000000000000000110000100000111110011000000
00000000000000000000000000000000000000000000000100001110000100000110100001000000
00000000000000000000000000000000000000000000000111111111000110000100011111110000
00000000000000000000000000000000000000000000011111111111100111001110011111111110
00000000000000000000000000000000000000000000000110110001110011001110000011111110
00000000000000000000000000000000000000000000000000000001100001111100000011100000
00000000000000000000000000000000000000000000000000000001100001111100000011100000
00000000000000000000000000000000000000000000000000000011100011111111001111110000
00000000000000000000000000000000000000000000000000000011100111111111111111111100
00000000000000000000000000000000000000000000000000000011100111011111111111001000
00000000000000000000000000000000000000000000000010000011111110001111100010000000
00000000000000000000000000000000000000000000000011000111111110001111100010000000
00000000000000000000000000000000000000000000001111111111111111001111111111000000
00000000000000000000000000000000001110001000111111111111111111001111111111111100
00000000000000000000000000000000001010001100100000111111111111001111111111100110
00000000000000000000000000000000001110001100000000011111111011111111111111000010
00000000000000000000000000000000001111101100111100011111110011111111111111000000
00000000000000000000000000000000000001101101111100111111100111111111011111110000
00000000000000000000000000000000011111011100111111110011111111111111111111111100
00000000000000000000000000000000010010111000111111110011111111111111111100111110
00000000000000000000000000000000000111111111111111110011111111111111110000001110
00000000000000000000000000000000000110111111111111111111111111111111110000011110
00000000000000000000000000000000001100011000111111111111111111111111111111111110
00000000000000000000000000000000000100011100111111111111111111121111111111111010
00000000000000000000000000000000000110001100111111111111111111111111111111111000
00000000000000000000000000000000000011001111111111111111111111111111111111111000
00000000000000000000000000000011110011000111111111100011111111111111111111111000
00000000000000000000000000000010001111001111111111110011111111111110011111111110
00000000000000000000000000000010001111111111111111111111111111111110011111111110
00000000000000000000000000000010000111111010111111111111111111111110011111111110
00000000000000000000000000000010001111111011111100111000111111111110001111111110
00000000000000000000000000000011011100011010001110000000111111111110011110111110
00000000000000000000000000000011111100001010011111100001110111101110111110011010
00000000000000000000000000000010110100011111111111110011100111111110111110110000
00000000000000000000000000000110100110001011100111110011000111111111111100110000
00000000000000000000000000000000000011011011000111110011001111111111000001110000
00000000000000000000000000000000000001111001000111100011101111100111100011111000
00000000000000000000000000000000000011011001111111100011111111000111100110111000
00000000000000000000000000000000001110011111111111110011111111000110111100010000
00000000000000000000000000000000000000001111111000011011111111101100100000000000
00000000000000000000000000000000000000011100000000000010011000011000000000000000
00000000000000000000000000000000000000001100000000000000000000000000000000000000
00000000000000000000000000000000000000000100000000000000000000000000000000000000
00000000000000000000000000000000000000000000000000000000000000000000000000000000
00000000000000000000000000000000000000000000000000000000000000000000000000000000
00000000000000000000000000000000000000000000000000000000000000000000000000000000
00000000000000000000000000000000000000000000000000000000000000000000000000000000
00000000000000000000000000000000000000000000000000000000000000000000000000000000
