80 80
00000000000000000000000000000000000000000000000000000000000000000000000000000000
00000000000000000000000000000000000000000000000000011000000110000111111111111110
00000000000000000000000000000000000000000000000000001000001110000011111111111110
00000000000000000000000000000000000000000000000000001000011111000111111111111110
00000000000000000000000000000000000000000000000000011001111111100110011111121110
00000000000000000000000000000000000000000000000001110011111111111110001111111110
00000000000000000000000000000000000000000000000001000011000111111100001111111110
00000000000000000000000000000000000000000000000001000010011111000111111111111110
00000000000000000000000000000000000000000000000001100001111110000111111111111110
00000000000000000000000000000000000000000000000000110001000010001100011101111110
00000000000000000000000000000000000000000000000001110111100010011100001001111110
00000000000000000000000000000000000000000000000001100100110011100110001101111110
00000000000000000000000000000000000000000000000000101000010001100011011001111100
00000000000000000000000000000000000000000000000000111000010000000001011011111110
00000000000000000000000000000000000000000000000000111000110000001111011111011110
00000000000000000000000000000000000000000000000000111111100000011110011111111010
00000000000000000000000000000000000000000000000001100110000000001100001111110010
00000000000000000000000000000000000000000010000001100000000000000000000001110000
00000000000000000000000000000000000000000010000001100000000000000000000000010000
00000000000000000000000000000000000000000011100001100000000000000000000000010000
00000000000000000000000000000000000000011111111000100000000000000000000000010000
00000000000000000000000000000000000000000111011001100000000000000000000000010000
00000000000000000000000000000000000000000110001111100000000000000000000000000000
00000000000000000000000000000000000000000100011111000000000000000000000000000000
00000000000000000000000000000000000000001100111110100000000000000000000000000000
00000000000000000000000000000000000000011100111111100000000000000000000000000000
00000000000000000000000000000000000000000011111111000000000000000000000000000000
00000000000000000000000000000000000000000001001100000000000000000000000000000000
00000000000000000000000000000000000000000001000000000000000000000000000000000000
00000000000000000000000000000000000000000001000000000000000000000000000000000000
00000000000000000000000000000000000000000000000000000000000000000000000000000000
00000000000000000000000000000000000000000000000000000000000000000000000000000000
00000000000000000000000000000000000000000000000000000000000000000000000000000000
00000000000000000000000000000000000000000000000000000000000000000000000000000000
00000000000000000000000000000000000000000000000000000000000000000000000000000000
00000000000000000000000000000000000000000000000000000000000000000000000000000000
00000000000000000000000000000000000000000000000000000000000000000000000000000000
00000000000000000000000000000000000000000000000000000000000000000000000000000000
00000000000000000000000000000000000000000000000000000000000000000000000000000000
00000000000000000000000000000000000000000000000000000000000000000000000000000000
00000000000000000000000000000000000000000000000000000000000000000000000000000000
00000000000000000000000000000000000000000000000000000000000000000000000000000000
00000000000000000000000000000000000000000000000000000000000000000000000000000000
00000000000000000000000000000000000000000000000000000000000000000000000000000000
00000000000000000000000000000000000000000000000000000000000000000000000000000000
00000000000000000000000000000000000000000000000000000000000000000000000000000000
00000000000000000000000000000000000000000000000000000000000000000000000000000000
00000000000000000000000000000000000000000000000000000000000000000000000000000000
00000000000000000000000000000000000000000000000000000000000000000000000000000000
00000000000000000000000000000000000000000000000000000000000000000000000000000000
00000000000000000000000000000000000000000000000000000000000000000000000000000000
00000000000000000000000000000000000000000000000000000000000000000000000000000000
00000000000000000000000000000000000000000000000000000000000000000000000000000000
00000000000000000000000000000000000000000000000000000000000000000000000000000000
00000000000000000000000000000000000000000000000000000000000000000000000000000000
00000000000000000000000000000000000000000000000000000000000000000000000000000000
00000000000000000000000000000000000000000000000000000000000000000000000000000000
00000000000000000000000000000000000000000000000000000000000000000000000000000000
00000000000000000000000000000000000000000000000000000000000000000000000000000000
00000000000000000000000000000000000000000000000000000000000000000000000000000000
00000000000000000000000000000000000000000000000000000000000000000000000000000000
00000000000000000000000000000000000000000000000000000000000000000000000000000000
00000000000000000000000000000000000000000000000000000000000000000000000000000000
00000000000000000000000000000000000000000000000000000000000000000000000000000000
00000000000000000000000000000000000000000000000000000000000000000000000000000000
00000000000000000000000000000000000000000000000000000000000000000000000000000000
00000000000000000000000000000000000000000000000000000000000000000000000000000000
00000000000000000000000000000000000000000000000000000000000000000000000000000000
00000000000000000000000000000000000000000000000000000000000000000000000000000000
00000000000000000000000000000000000000000000000000000000000000000000000000000000
00000000000000000000000000000000000000000000000000000000000000000000000000000000
00000000000000000000000000000000000000000000000000000000000000000000000000000000
00000000000000000000000000000000000000000000000000000000000000000000000000000000
00000000000000000000000000000000000000000000000000000000000000000000000000000000
00000000000000000000000000000000000000000000000000000000000000000000000000000000
00000000000000000000000000000000000000000000000000000000000000000000000000000000
00000000000000000000000000000000000000000000000000000000000000000000000000000000
00000000000000000000000000000000000000000000000000000000000000000000000000000000
00000000000000000000000000000000000000000000000000000000000000000000000000000000
00000000000000000000000000000000000000000000000000000000000000000000000000000000
