80 80
00000000000000000000000000000000000000000000000000000000000000000000000000000000
00000000000000000000000000000000000000011000000000000011111111111100000000000000
00000000000000000000000000000000000011111000000000000011111100011100000000000000
00000000000000000000000000000000000111111000000000000011111100011110000110000000
00000000000000000000000000000000000111111000011111111111111111111111000100000000
00000000000000000000000000000000000111111100111111111111111111111111111100000000
00000000000000000000000000000000001101111111111111100111111111111111111000000000
00000000000000000000000000000000001001100000000111000011111111111111110000000000
00000000000000000000000000000000000011100000011111000011111111001110110000000000
00000000000000000000000000000000000111111000011111100011111111001100111000110000
00000000000000000000000000000000001111111110111001110011111111001110011100111000
00000000000000000000000000000000001111001111110000111011111111000110001111110000
00000000000000000000000000000000001111000111110000111001111111111111000011110000
00000000000000000000000000000000011111000100110000111111111111111111000000011000
00000000000000000000000000000111111111001100111001111111111111101100000110011000
00000000000000000000000000000011111110011100111001111111111111000110111111110000
00000000000000000000000000000111011110001000111001111111111110000110010001100000
00000000000000000000000000000000001111000111110011001111111110001111000000000000
00000000000000000000000000000001000111000011110011001111111111111111100000000000
00000000000000000000000001111011110111111111111111111011111111111110110000000000
00000000000000000000000011111111111111111111111111111011111111111100011100111100
00000000000000000000000011111111111101101111011100110011111111111100001111100110
00000000000000000000000110000000000001000000000100000011001110111100001011000110
00000000000000000000000010000000000000000010000100000011000000011100000010001110
00000000000000000000000011100000000000001111100110000011000011111100000010011110
00000000000000000000000011000000000000001100111111111011100111111111000000010000
00000000000000000000000111000000000000011000001111001101111111110110000000000000
00000000000000000000000101110000000000001000000010000011011111111110000000000000
00000100000000000001000100110000000000000000000010000000011011111100000000000000
01111100001111110111100111000000000000000000000011000000111001111000000000000000
01111110011111111111111111110111000000000000000001110011111111111100000000000000
01110111111100000001111000111110000000000000000000011111000000100000000000000000
01110001111100000001111100000110000000000000000000000000000000000000000000000000
00011000111110000001100110000011000000000000000000000000000000000000000000000000
00001100111111100011100011000000000000000000000000000000000000000000000000000000
00001111111111111101100011100000000000000000000000000000000000000000000000000000
00000111001110011100110001111000000000000000000000000000000000000000000000000000
00000110000000011100011001110000000000000000000000000000000000000000000000000000
00001110000000001100000001100000000000000000000000000000000000000000000000000000
00001100001111001000000011100000000000000000000000000000000000000000000000000000
01001110011111111101111111111110000000000000000000000000000000000000000000000000
01001110111000000001001001111000000000000000000000000000000000000000000000000000
01000111111000000010001001001000000000000000000000000000000000000000000000000000
01000111111110000111110000000000000000000000000000000000000000000000000000000000
01001111111111011111110000000000000000000000000000000000000000000000000000000000
01001111111111111001110000000000000000000000000000000000000000000000000000000000
01001111101111110000110000000000000000000000000000000000000000000000000000000000
01111101100111100000010000000000000000000000000000000000000000000000000000000000
01000001100000100000010000000000000000000000000000000000000000000000000000000000
00001111111000010000110000000000000000000000000000000000000000000000000000000000
01011111111100010011110000000000000000000000000000000000000000000000000000000000
01111111111110011011100000000000000000000000000000000000000000000000000000000000
01110001111110011001000000000000000000000000000000000000000000000000000000000000
00110001111111111001000000000000000000000000000000000000000000000000000000000000
01111111111111111001100001110000000000000000000000000000000000000000000000000000
01111111111111111000100001111000000000000000000000000000000000000000000000000000
01111111111111111000110011000000000000000000000000000000000000000000000000000000
01110000111111111111110110000000000000000000000000000000000000000000000000000000
01110000011111111111111110010000100000000000000000000000000000000000000000000000
01111111111111111001111101111011100000000000000000000000000000000000000000000000
01111111111111111001111111111111000000000000000000000000000000000000000000000000
01111111111111111001111111001111000000000000000000000000000000000000000000000000
01111111111111110000111110001111100000000000000000000000000000000000000000000000
01111111111111110000011100001100000000000000000000000000000000000000000000000000
01111111111111111000111110001110000000000000000000000000000000000000000000000000
01111111211111111111111111111111000000000000000000000000000000000000000000000000
01111111111111111111100100110111000000000000000000000000000000000000000000000000
01111111111111111111001000000011100000000000000000000000000000000000000000000000
01111111111111111110011000000011000000000000000000000000000000000000000000000000
01111111111111111111110000000011000000000000000000000000000000000000000000000000
01111111111111111111110011100010000000000000000000000000000000000000000000000000
01111111111111111111100010111110000000000000000000000000000000000000000000000000
01110000111111001111110110011100000000000000000000000000000000000000000000000000
01110000011111001111111111111100000000000000000000000000000000000000000000000000
01111110111111111111111101111110000000000000000000000000000000000000000000000000
01111111111111111001111111110110000000000000000000000000000000000000000000000000
01000111111111110001111111000111000000000000000000000000000000000000000000000000
00000011111111100001111111001110000000000000000000000000000000000000000000000000
00000011111111100001111111100110000000000000000000000000000000000000000000000000
00000000000000000000000000000000000000000000000000000000000000000000000000000000
