80 80
00000000000000000000000000000000000000000000000000000000000000000000000000000000
00000000000000000000000000000000000000000000000000000000000000000000000000000000
00000000000000000000000000000000000000000000000000000000000000000000000000000000
00000000000000000000000000000000000000000000000000000000000000000000000000000000
00000000000000000000000000000000000000000000000000000000000000000000000000000000
00000000000000000000000000000000000000000000000000000000000000000000000000000000
00000000000000000000000000000000000000000000000000000000000000000000000000000000
00000000000000000000000000000000000000000000000000000000000000000000000000000000
00000000000000000000000000000000000000000000000000000000000000000000000000000000
00000000000000000000000000000000000000000000000000000000000000000000000000000000
00000000000000000000000000000000000000000000000000000000000000000000000000000000
00000000000000000000000000000000000000000000000000000000000000000000000000000000
00000000000000000000000000000000000000000000000000000000000000000000000000000000
00000000000000000000000000000000000000000000000000000000000000000000000000000000
00000000000000000000000000000000000000000000000000000000000000000000000000000000
00000000000000000000000000000000000000000000000000000000000000000000000000000000
00000000000000000000000000000000000000000000000000000000000000000000000000000000
00000000000000000000000000000000000000000000000000000000000000000000000000000000
00000000000000000000000000000000000000000000000000000000000000000000000000000000
00000000000000000000000000000000000000000000000000000110000000000000000000000000
00000000000000000000000000000000000000000000000001111111100000000000000000000000
00000000000000000000000000000000000000000000000000001100110000000000000000000000
00000000000000000000000000000000000000000000000000000100000000000000000000000000
00000000000000000000000000000000000000000000000110000111000000000000000000000000
00000000000000000000000000000000000000000000001111000111000011001110000000000000
00000000000000000000000000000000000000000001111111110001000111011110011111000000
00000000000000000000000000000000000000000001100000011001111110011110000011100000
00000000000000000000000000000000000000000000000000001111111100011100000011000000
00000000000000000000000000000000000000000000000000000011111110011000000111000000
00000000000000000000000000000000000000000000000000000011111111111111011100000000
00000000000000000000000000000000000000000000000000000011111111111111111100000000
00000000000000000000000000000000000000000000000000000001111111111111111100000000
00000000000000000000000000000000000000000000000000000001111111211111111000000000
00000000000000000000000000000000000000000000000000000001111111111110000000000000
00000000000000000000000000000000000000000000000000000001111111111110000000000000
00000000000000000000000000000000000000000000000001110011111111111110000000010000
00000000000000000000000000000000000000000000000011100011011111111100000000011000
00000000000000000000000000000000000000000000000011100110000000111100000000001100
00000000000000000000000000000000000000000000000001111100000000001110000001000100
00000000000000000000000000000000000000000000000000110111110110001111001111001100
00000000000000000000000000000000000000000000000000100011100111001111011111111110
00000000000000000000000000000000000000000000000000100011000011101110011001100000
00000000000000000000000000000000000000000000000000000011000000100001110000000000
00000000000000000000000000000000000000000000000000000111110000100001110000000000
00000000000000000000000000000000000000000000000001100111110011100111011100000000
00000000000000000000000000000000000000000000000011111111100111001110111110000000
00000000000000000000000000000000000000000000000000111111001110001000111110000000
00000000000000000000000000000000000000000000000000011111111100010000111010000000
00000000000000000000000000000000000000000000000000011101111000010000011000000000
00000000000000000000000000000000000000000000000000001101111100011000011000000000
00000000000000000000000000000000000000000000000000000111100111111110011000000000
00000000000000000000000000000000000000000000000000000100000001100011001100000000
00000000000000000000000000000000000000000000000000001100000000100000000110000000
00000000000000000000000000000000000000000000000000000110000000000000100010000000
00000000000000000000000000000000000000000000000000000011000000000001110111110000
00000000000000000000000000000000000000000000000000000001000111111111111110010000
00000000000000000000000000000000000000000000000000000001100011110011000000011000
00000000000000000000000000000000000000000000000000000000111111100000000000001100
00000000000000000000000000000000000000000000000000000000111111000000000000000000
00000000000000000000000000000000000000000000000000000001111110000000000000000000
00000000000000000000000000000000000000000000000000000001101111000000000000000000
00000000000000000000000000000000000000000000000000000011011001000000000000000000
00000000000000000000000000000000000000000000000000000011110000000000000000000000
00000000000000000000000000000000000000000000000000000001110000000000000000000000
00000000000000000000000000000000000000000000000000000011100000000000000000000000
00000000000000000000000000000000000000000000000000000011110000000000000000000000
00000000000000000000000000000000000000000000000000000000010000000000000000000000
00000000000000000000000000000000000000000000000000000000000000000000000000000000
00000000000000000000000000000000000000000000000000000000000000000000000000000000
00000000000000000000000000000000000000000000000000000000000000000000000000000000
00000000000000000000000000000000000000000000000000000000000000000000000000000000
00000000000000000000000000000000000000000000000000000000000000000000000000000000
00000000000000000000000000000000000000000000000000000000000000000000000000000000
00000000000000000000000000000000000000000000000000000000000000000000000000000000
00000000000000000000000000000000000000000000000000000000000000000000000000000000
00000000000000000000000000000000000000000000000000000000000000000000000000000000
00000000000000000000000000000000000000000000000000000000000000000000000000000000
00000000000000000000000000000000000000000000000000000000000000000000000000000000
00000000000000000000000000000000000000000000000000000000000000000000000000000000
00000000000000000000000000000000000000000000000000000000000000000000000000000000
