80 80
00000000000000000000000000000000000000000000000000000000000000000000000000000000
00000000000000000000000000000000000000000000000000000000000000000000000000000000
00000000000000000000000000000000000000000000000000000000000000000000000000000000
00000000000000000000000000000000000000000000000000000000000000000000000000000000
00000000000000000000000000000000000000000000000000000000000000000000000000000000
00000000000000000000000000000000000000000000000000000000000000000000000000000000
00000000000000000000000000000000000000000000000000000000000000000000000000000000
00000000000000000000000000000000000000000000000000000000000000000000000000000000
00000000000000000000000000000000000000000000000000000000000000000000000000000000
00000000000000000000000000000000000000000000000000000000000000000000000000000000
00000000000000000000000000000000000000000000000000000000000000000000000000000000
00000000000000000000000000000000000000000000000000000000000000000000000000000000
00000000000000000000000000000000000000000000000000000000000000000000000000000000
00000000000000000000000000000000000000000000000000000000000000000000000000000000
00000000000000000000000000000000000000000000000000000000000000000000000000000000
00000000000000000000000000000000000000000000000000000000000000000000000000000000
00000000000000000000000000000000000000000000000000000000000000000000000000000000
00000000000000000000000000000000000000000000000000000000000000000000000000000000
00000000000000000000000000000000000000000000000000000000000000000000000000000000
00000000000000000000000000000000000000000000000000000000000000000000000000000000
00000000000000000000000000000000000000000000000000000000000000000000000000000000
00000000000000000000000000000000000000000000000000000000000000000000000000000000
00000000000000000000000000000000000000000000000000000000000000000000000000000000
00000000000000000000000000000000000000000000000000000000000000000000000000000000
00000000000000000000000000000000000000000000000000000000000000000000000000000000
00000000000000000000000000000000000000000000000000000000000000000000000000000000
00000000000000000000000000000000000000000000000000000000000000000000000000000000
00000000000000000000000000000000000000000000000000000000000000000000000000000000
00000000000000000000000000000000000000000000000000000000000000000000000000000000
00000000000000000000000000000000000000000000000000000000000000000000000000000000
00000000000000000000000000000000000000000000000000000000000000000000000000000000
00000000000000000000000000000000000000000000000000000000000000000000000000000000
00000000000000000000000000000000000000000000000000000000000000000000000000000000
00000000000000000000000000000000000000000000000000110000000000011000000000000000
00000000000000000000000000000000000000000000000000110000111100011111110000000000
00000000000000000000000000000000000000000000000000100011100111111111111100000000
00000000000000000000000000000000000000000000000001100010000001111111000100000000
00000000000000000000000000000000000000000000000001110100000000011111000010000000
00000000000000000000000000000000000000000000000000111100000000001111000011000000
00000000000000000000000000000000000000000000000000111111000110001111111111110000
00000000000000000000000000000000000000000000000001111111101111111111111111110000
00000000000000000000000000000000000000000000000001111001111111111110111110110000
00000000000000000000000000000000000000000000000000111111111000000001111111100000
00000000000000000000000000000000000000000000001100011111110000000100110000000000
00000000000000000000000000000000000000000000010110011111111111001100010000111000
00000000000000000000000000000000000000000000011111111111111111101110011101111110
00000000000000000000000000000000000000000000010001000111111111111110000111000010
00000000000000000000000000000000000000000000000000000111111111111100000000000000
00000000000000000000000000000000000000000000000000001111100110001100001000000000
00000000000000000000000000000000000000000000000000111111000110001100111000000000
00000000000000000000000000000000000000000000000000111111100111001110011100111000
00000000000000000000000000000000000000000000000001111111110111000111001111111000
00000000000000000000000000000000000000000000000001111100011111101111001100111000
00000000000000000000000000000000000000000000011111111100001111111111111100110000
00000000000000000000000000000000000000001011111111111111000111101110111100110000
00000000000000000000000000000000000000001111111111111111111111001110011100111000
00000000000000000000000000000000000010001111111110111111111111001110011100011110
00000000000000000000000000000000000011111111111100001111111111000111011110000000
00000000000000000000000000000000000000011111010000001111111111110011111111000000
00000000000000000000000000000000000000001111110001111111101111111111111111110000
00000000000000000000000000000000000000001111110011111011100111111111111111111000
00000000000000000000000000000000000000001011010011110011000011111111111121111110
00000000000000000000000000000000000000001011100011000011000011110001111111111110
00000000000000000000000000000000000011111111100001100011001111110001111111100110
00000000000000000000000000000000000000111111110001110011011111111111111111110000
00000000000000000000000000000000000000011110010001110011111111011111111111111110
00000000000000000000000000000000000000001100011011100001111111001111111110001000
00000000000000000000000000000000000000001000000011100000001111001111111110000000
00000000000000000000000000000000000000001000000011100000001111001110011110000000
00000000000000000000000000000000000000001000000011110100011111000100001011011110
00000000000000000000000000000000000000001000000001111111111111000100001111111010
00000000000000000000000000000000000000001100000001111000000111000100001000110000
00000000000000000000000000000000000000000100000000010000000111100000000000100000
00000000000000000000000000000000000000000000000000000000001111000000000001100000
00000000000000000000000000000000000000000000000000000000000011000000001011110000
00000000000000000000000000000000000000000000000000000000000010000000011110010000
00000000000000000000000000000000000000000000000000000000000000000000001100010000
00000000000000000000000000000000000000000000000000000000000000000000000111100000
00000000000000000000000000000000000000000000000000000000000000000000000001000000
00000000000000000000000000000000000000000000000000000000000000000000000000000000
