80 80
00000000000000000000000000000000000000000000000000000000000000000000000000000000
00000000000000000000000000000000000000000000000000000000000000000000000000000000
00000000000000000000000000000000000000000000000000000000000000000000000000000000
00000000000000000000000000000000000000000000000000000000000000000000000000000000
00000000000000000000000000000000000000000000000000000000000000000000000000000000
00000000000000000000000000000000000000000000000000000000000000000000000000000000
00000000000000000000000000000000000000000000000000000000000000000000000000000000
00000000000000000000000000000000000000000000000000000000000000000000000000000000
00000000000000000000000000000000000000000000000000000000000000000000000000000000
00000000000000000000000000000000000000000000000000000000000000000000000000000000
00000000000000000000000000000000000000000000000000000000000000000000000000000000
00000000000000000000000000000000000000000000000000000000000000000000000000000000
00000000000000000000000000000000000000000000000000000000000000000000000000000000
00000000000000000000000000000000000000000000000000000000000000000000000000000000
00000000000000000000000000000000000000000000000000000000000000000000000000000000
00000000000000000000000000000000000000000000000000000000000000000000000000000000
00000000000000000000000000000000000000000000000000000000000000000000000000000000
00000000000000000000000000000000000000000000000000000000000000000000000000000000
00000000000000000000000000000000000000000000000000000000000000000000000000000000
00000000000000000000000000000000000000000000000000000000000000000000000000000000
00000000000000000000000000000000000000000000000000000000000000000000000000000000
00000000000000000000000000000000000000000000000000000000000000000000000000000000
00000000000000000000000000000000000000000000000000000000000000000000000000000000
00000000000000000000000000000000000000000000000000000000000000000000000000000000
00000000000000000000000000000000000000000000000000000000000000000000000000000000
00000000000000000000000000000000000000000000000000000000000000000000000000000000
00000000000000000000000000000000000000000000000000000000000000000000000000000000
00000000000000000000000000000000000000000000000000000000000000000000000000000000
00000000000000000000000000000000000000000000000000000000000000000000000000000000
00000000000000000000000000000000000000000000000000000000000000000000000000000000
00000000000000000000000000000000000000000000000000000000000000000000000000000000
00000000000000000000000000000000000000000000000000000000000000000000000000000000
00000000000000000000000000000000000000000000000000000000000000000000000000000000
00000000000000000000000000000000000000000000000000000000000000000000000000000000
00000000000000000000000000000000000000000000000000000000000000000000000000000000
00000000000000000000000000000000000000000000000000000000000000000000000000000000
00000000000000000000000000000000000000000000000000000000000000000000000000000000
00000000000000000000000000010000000000000000000000000000000000000000000000000000
00000000000000000000010111011000000000000000000000000000000000000000000000000000
00000000000000100000110011111000000000000000000000000000000000000000000000000000
00000000000001111001100011110000000000000000000000000000000000000000000000000000
00000000000000001111100001110000000000000000000000000000000000000000000000000000
00000000000000000011100001100000000000000000000000000000000000000000000000000000
00000000000000000011110000100000000000000000000000000000000000000000000000000000
00000000000000001111111001110000000000000000000000000000000000000000000000000000
00000000000000111111111111110000000000000000000000000000000000000000000000000000
00000000000001111111211111000000000000000000000000000000000000000000000000000000
00000000000001111111111100000000000000000000000000000000000000000000000000000000
00000000011000100111111100000000000000000000000000000000000000000000000000000000
00000000001000111111111111000000000000000000000000000000000000000000000000000000
00000000001000111111111111100000000000000000000000000000000000000000000000000000
00000000011000111001100011100000000000000000000000000000000000000000000000000000
00000000111000111001100001110000000000000000000000000000000000000000000000000000
00000000010000111111100001111100000000000000000000000000000000000000000000000000
00000100111000111111100001100110000000000000000000000000000000000000000000000000
00000111111111111111110001100010000000000000000000000000000000000000000000000000
01000111111111111101110011000011000000000000000000000000000000000000000000000000
01000111000100111111111111000001000000000000000000000000000000000000000000000000
01100111000100011111111110000000000000000000000000000000000000000000000000000000
01100111011000011111111111000010000000000000000000000000000000000000000000000000
01111111111100111111111111111110000000000000000000000000000000000000000000000000
01101101111100111011111100111111000000000000000000000000000000000000000000000000
00001100111100111000001000001111000000000000000000000000000000000000000000000000
00001000011110011000001000011111000000000000000000000000000000000000000000000000
00000000001011011100111001111110000000000000000000000000000000000000000000000000
00000000001111111001110011111110000000000000000000000000000000000000000000000000
00000000001111100001100011011010000000000000000000000000000000000000000000000000
00000000000010000011100110001000000000000000000000000000000000000000000000000000
00000000000011000000111110000000000000000000000000000000000000000000000000000000
00000000000001000000101111000000000000000000000000000000000000000000000000000000
00000000001111000000101101000000000000000000000000000000000000000000000000000000
00000000000110000000110001000000000000000000000000000000000000000000000000000000
00000000000011000000000001000000000000000000000000000000000000000000000000000000
00000000000000000000000000000000000000000000000000000000000000000000000000000000
00000000000000000000000000000000000000000000000000000000000000000000000000000000
00000000000000000000000000000000000000000000000000000000000000000000000000000000
00000000000000000000000000000000000000000000000000000000000000000000000000000000
00000000000000000000000000000000000000000000000000000000000000000000000000000000
00000000000000000000000000000000000000000000000000000000000000000000000000000000
00000000000000000000000000000000000000000000000000000000000000000000000000000000
