80 80
00000000000000000000000000000000000000000000000000000000000000000000000000000000
00000000000000000000000000000000000000000000000000000000000000000000000000000000
00000000000000000000000000000000000000000000000000000000000000000000000000000000
00000000000000000000000000000000000000000000000000000000000000000000000000000000
00000000000000000000000000000000000000000000000000000000000000000000000000000000
00000000000000000000000000000000000000000000000000000000000000000000000000000000
00000000000000000000000000000000000000000000000000000000000000000000000000000000
00000000000000000000000000000000000000000000000000000000000000000000000000000000
00000000000000000000000000000000000000000000000000000000000000000000000000000000
00000000000000000000000000000000000000000000000000000000000000000000000000000000
00000000000000000000000000000000000000000000000000000000000000000000000000000000
00000000000000000000000000000000000000000000000000000000000000000000000000000000
00000000000000000000000000000000000000000000000000000000000000000000000000000000
00000000000000000000000000000000000000000000000000000000000000000000000000000000
00000000000000000000000000000000000000000000000000000000000000000000000000000000
00000000000000000000000000000000000000000000000000000000000000000000000000000000
00000000000000000000000000000000000000000000000000000000000000000000000000000000
00000000000000000000000000000000000000000000000000000000000000000000000000000000
00000000000000000000000000000000000000000000000000000000000000000000000000000000
00000000000000000000000000000000000000000000000000000000000000000000000000000000
00000000000000000000000000000000000000000000000000000000000000000000000000000000
00000000000000000000000000000000000000000000000000000000000000000000000000000000
00000000000000000000000000000000000000000000000000000000000000000000000000000000
00000000000000000000000000000000000000000000000000000000000000000000000000000000
00000000000000000000000000000000000000000000000000000000000000000000000000000000
00000000000000000000000000000000000000000000000000000000000000000000000000000000
00000000000000000000000000000000000000000000000000000000000000000000000000000000
00000000000000000000000000000000000000000000000000000000000000000000000000000000
00000000000000000000000000000000000000000000000000000000000000000000000000000000
00000000000000000000000000000000000000000000000000000000000000000000000000000000
00000000000000000000000000000000000000000000000000000000000000000000000000000000
00000000000000000000000000000000000000000000000000000000000000000000000000000000
00000000000000000000000000000000000000000000000000000000000000000000000000000000
00000000000000000000000000000000000000000000000000000000000000000000000000000000
00000000000000000000000000000000000000000000000000000000000000000000000000000000
00000000000000000000000000000000000000000000000000000000000000000000000000000000
00000000000000000000000000000000000000000000000000000000000000000000000000000000
00000000000000000000000000000000000000000000000000000000000000000000000000000000
00000000000000000000000000000000000000000000000000000000000000000000000000000000
00000000000000000000000000000000000000000000000000000000000000000000000000000000
00000000000000000000000000000000000000000000000000000000000000000000000000000000
00000000000000000000000000000000000000000000000000000100000000000000000000000000
00000000000000000000000000000000000000000000000000000100111100000000000000000000
00000000000000000000000000000000000000000000000000000111011100000000000000000000
00000000000000000000000000000000000000000000000001100111001100000000000000010000
00000000000000000000000000000000000000000000111001110011111111000000000000010000
00000000000000000000000000000000000000000001110001110001111011000000000000010000
00000000000000000000000000000000000000000001111111111101100001100000000000010000
00000000000000000000000000000000000000000000100100110111000000110000000000010000
00000000000000000000000000000000000000000100100000110001100000111101100000010000
00000000000000000000000000000000001111111111111001100001000111111111111100010000
00000000000000000000000000000000000000010010000001100011000111110111110000010000
00000000000000000000000000000000000000000010000011000011000111100001100000010000
00000000000000000000000000000000000000000000000110001111000011100000110000011100
00000000000000000000000000000000000000000000000000111111000111110100011000010000
00000000000000000000000000000000000000000000000001110111111111111110011000010000
00000000000000000000000000000000000000000000000001000011121111001111001100011000
00000000000000000000000000000000000000000101000000000011111100001111000110001100
00000000000000000000000000000000000000000111100000000000111100011110000010001100
00000000000000000000000000000000000000001101111100000001111111011101011111011110
00000000000000000000000000000000000000001000111111111111111111001111011111111110
00000000000000000000000000000000000000011000111110001110011110000111011001111000
00000000000000000000000000000000000011110000000100000000011110001111111001111000
00000000000000000000000000000000000011100000000000000000011110011110010001111000
00000000000000000000000000000000000011100000000000000000000011111110011011111000
00000000000000000000000000000000000001100000000000000000000011111100011111111000
00000000000000000000000000000000000000100000000000000000000011111100001111100000
00000000000000000000000000000000000000100000000000000000000011111100000010000000
00000000000000000000000000000000000000000000000000000000000000011100000000000000
00000000000000000000000000000000000000000000000000000000000000001100000000000000
00000000000000000000000000000000000000000000000000000000000000000100000000000000
00000000000000000000000000000000000000000000000000000000000000001110000000000000
00000000000000000000000000000000000000000000000000000000000000000000000000000000
00000000000000000000000000000000000000000000000000000000000000000000000000000000
00000000000000000000000000000000000000000000000000000000000000000000000000000000
00000000000000000000000000000000000000000000000000000000000000000000000000000000
00000000000000000000000000000000000000000000000000000000000000000000000000000000
00000000000000000000000000000000000000000000000000000000000000000000000000000000
00000000000000000000000000000000000000000000000000000000000000000000000000000000
00000000000000000000000000000000000000000000000000000000000000000000000000000000
