80 80
00000000000000000000000000000000000000000000000000000000000000000000000000000000
00000000000000000000000000000000000000000000000000000000000000000000000000000000
00000000000000000000000000000000000000000000000000000000000000000000000000000000
00000000000000000000000000000000000000000000000000000000000000000000000000000000
00000000000000000000000000000000000000000000000000000000000000000000000000000000
00000000000000000000000000000000000000000000000000000000000000000000000000000000
00000000000000000000000000000000000000000000000000000000000000000000000000000000
00000000000000000000000000000000000000000000000000000000000000000000000000000000
00000000000000000000000000000000000000000000000000000000000000000000000000000000
00000000000000000000000000000000000000000000000000000000000000000000000000000000
00000000000000000000000000000000000000000000000000000000000000000000000000000000
00000000000000000000000000000000000000000000000000000000000000000000000000000000
00000000000000000000000000000000000000000000000000000000000000000000000000000000
00000000000000000000000000000000000000000000000000000000000000000000000000000000
00000000000000000000000000000000000000000000000000000000000000000000000000000000
00000000000000000000000000000000000000000000000000000000000000000000000000000000
00000000000000000000000000000000000000000000000000000000000000000000000000000000
00000000000000000000000000000000000000000000000000000000000000000000000000000000
00000000000000000000000000000000000000000000000000000000000000000000000000000000
00000000000000000000000000000000000000000000000000000000000000000000000000000000
00000000000000000000000000000000000000000000000000000000000000000000000000000000
00000000000000000000000000000000000000000000000000000000000000000000000000000000
00000000000000000000000000000000000000000000000000000000000000000000000000000000
00000000000000000000000000000000000000000000000000000000000000000000000000000000
00000000000000000000000000000000000000000000000000000000000000000000000000000000
00000000000000000000000000000000000000000000000000000000000000000000000000000000
00000000000000000000000000000000000000000000000000000000000000000000000000000000
00000000000000000000000000000000000000000000000000000000000000000000000000000000
00000000000000000000000000000000000000000000000000000000000000000000000000000000
00000000000000000000000000000000000000000000000000000000000000000000000000000000
00000000000000000000000000000000000000000000000000000000000000000000000000000000
00000000000000000000000000000000000000000000000000000000000000000000000000000000
00000000000000000000000000000000000000000000000000000000000000000000000000000000
00000000000000000000000000000000000000000000000000000000000000000000000000000000
00000000000000000000000000000000000000000000000000000000000000000000000000000000
00000000000000000000000000000000000000000000000000000000000000000000000000000000
00000000000000000000000000000000000000000000000000000000000000000000000000000000
00000000000000000000000000000000000000000000000000000000000000000000000000000000
00000000000000000000000000000000000000000000000000000000000000000000000000000000
00100110000000000000100000000000000000000000000000000000000000000000000000000000
01111100000000000001110000000000000000000000000000000000000000000000000000000000
00011100000000001001100000000000000000000000000000000000000000000000000000000000
00011000000000001111000000000000000000000000000000000000000000000000000000000000
00011111111000011111000000000000000000000000000000000000000000000000000000000000
00011110001000011011000000000000000000000000000000000000000000000000000000000000
00011100001000010000000000000000000000000000000000000000000000000000000000000000
01011110001000110000000000000000000000000000000000000000000000000000000000000000
01111110011111100000000000000000000000000000000000000000000000000000000000000000
01111001111111000000000000000000000000000000000000000000000000000000000000000000
01111111111110000000000000000000000000000000000000000000000000000000000000000000
01111111111110000000000000000000000000000000000000000000000000000000000000000000
00111111111100000000000000000000000000000000000000000000000000000000000000000000
00110000111100000000001100000000000000000000000000000000000000000000000000000000
00110000111000000000001000000000000000000000000000000000000000000000000000000000
01111100011000111111111000000000000000000000000000000000000000000000000000000000
01111111011100111011111000000000000000000000000000000000000000000000000000000000
01111111111100111001111110000000000000000000000000000000000000000000000000000000
01110011111100111111111100000000000000000000000000000000000000000000000000000000
01110011111100011111111100000000000000000000000000000000000000000000000000000000
01111111111100011110111000000000000000000000000000000000000000000000000000000000
01111111011100111111110000000000000000000000000000000000000000000000000000000000
01111110001111111011100000000000000000000000000000000000000000000000000000000000
01111110001111111111100000000000000000000000000000000000000000000000000000000000
01121110001111111011100000000000000000000000000000000000000000000000000000000000
01111110001111110001100000000000000000000000000000000000000000000000000000000000
01111111011111111001110000000000000000000000000000000000000000000000000000000000
01111111111111011000111000000000000000000000000000000000000000000000000000000000
00111111111001111100001000000000000000000000000000000000000000000000000000000000
00111111110001111100001000000000000000000000000000000000000000000000000000000000
01111111111111111100001100000000000000000000000000000000000000000000000000000000
01001111111111111110000100000000000000000000000000000000000000000000000000000000
00000111111110010011000100000000000000000000000000000000000000000000000000000000
00000001100000000010000000000000000000000000000000000000000000000000000000000000
00000000100000000000000000000000000000000000000000000000000000000000000000000000
00000101111111100010000000000000000000000000000000000000000000000000000000000000
00011111111111111111110000000000000000000000000000000000000000000000000000000000
00000111111100001000000000000000000000000000000000000000000000000000000000000000
00000000000000001000000000000000000000000000000000000000000000000000000000000000
00000000000000000000000000000000000000000000000000000000000000000000000000000000
00000000000000000000000000000000000000000000000000000000000000000000000000000000
