80 80
00000000000000000000000000000000000000000000000000000000000000000000000000000000
00000000000000000000000000000000000000000000000000000000000000000000000000000000
00000000000000000000000000000000000000000000000000000000000000000000000000000000
00000000000000000000000000000000000000000000000000000000000000000000000000000000
00000000000000000000000000000000000000000000000000000000000000000000000000000000
00000000000000000000000000000000000000000000000000000000000000000000000000000000
00000000000000000000000000000000000000000000000000000000000000000000000000000000
00000000000000000000000000000000000000000000000000000000000000000000000000000000
00000000000000000000000000000000000000000000000000000000000000000000000000000000
00000000000000000000000000000000000000000000000000000000000000000000000000000000
00000000000000000000000000000000000000000000000000000000000000000000000000000000
00000000000000000000000000000000000000000000000000000000000000000000000000000000
00000000000000000000000000000000000000000000000000000000000000000000000000000000
00000000000000000000000000000000000000000000000000000000000000000000000000000000
00000000000000000000000000000000000000000000000000000000000000000000000000000000
00000000000000000000000000000000000000000000000000000000000000000000000000000000
00000000000000000000000000000000000000000000000000000000000000000000000000000000
00000000000000000000000000000000000000000000000000000000000000000000000000000000
00000000000000000000000000000000000000000000000000000000000000000000000000000000
00000000000000000000000000000000000000000000000000000000000000000000000000000000
00000000000000000000000000000000000000000000000000000000000000000000000000000000
00000000000000000000000000000000000000000000000000000000000000000000000000000000
00000000000000000000000000000000000000000000000000000000000000000000000000000000
00000000000000000000000000000000000000000000000000000000000000000000000000000000
00000000000000000000000000000000000000000000000000000000000000000000000000000000
00000000000000000000000000000000000000000000000000000000000000000000000000000000
00000000000000000000000000000000000000000000000000000000000000000000000000000000
00000000000000000000000000000000000000000000000000000000000000000000000000000000
00000000000000000000000000000000000000000000000000000000000000000000000000000000
00000000000000000000000000000000000000000000000000000000000000000000000000000000
00000000000000000000000000000000000000000000000000000000000000000000000000000000
00000000000000000000000000000000000000000000000000000000000000000000000000000000
00000000000000000000000000000000000000000000000000000000000000000000000000000000
00000000000000000000000000000000000000000000000000000000000000000000000000000000
00000000000000000000000000000000000000000000000000000000000000000000000000000000
00000000000000000000000000000000000000000000000000000000000000000000000000000000
00000000000000000000000000000000000000000000000000000000000000000000000000000000
00000000000000000000000000000000000000000000000000000000000000000000000000000000
00000000000000000000000000000000000000000000000000000000000000000000000000000000
00000000000000000000000000000000000000000000000000000000000000000000000000000000
00000000000000000000000000000000000000000000000000000000000000000000000000000000
00000000000000000000000000000000000000000000000000000000000000000000000000000000
00000000000000000000000000000000000000000000000000000000000000000000000000000000
00000000000000000000000000000000000000000000000000000000000000000000000000000000
00000000000000000000000000000000000000000000000000000000000000000000011000100000
00000000000000000000000000000000000000000000000000000000000000000000011111111110
00000000000000000000000000000000000000000000000000000000000000000000001111111110
00000000000000000000000000000000000000000000000000000000000000000001111001000010
00000000000000000000000000000000000000000000000000000000000000000001100000110000
00000000000000000000000000000000000000000000000000000000000000000011111000111000
00000000000000000000000000000000000000000000000000000000000000000111111110111000
00000000000000000000000000000000000000000000000000000000000000001100000111111000
00000000000000000000000000000000000000000000000000000000000000000000000011110000
00000000000000000000000000000000000000000000000000000000000000001110000111110000
00000000000000000000000000000000000000000000000000000000000000001211001100110000
00000000000000000000000000000000000000000000000000000000000000001111011000111000
00000000000000000000000000000000000000000000000000000000000000001111111000011000
00000000000000000000000000000000000000000000000000000000000000100011111100011100
00000000000000000000000000000000000000000000000000000000000000110001111111111100
00000000000000000000000000000000000000000000000000000000000011111111111101111110
00000000000000000000000000000000000000000000000000000000000111111111111101111110
00000000000000000000000000000000000000000000000000000000000011111111111110111100
00000000000000000000000000000000000000000000000000000000000001111111001110111000
00000000000000000000000000000000000000000000000000000011001001111011001110011000
00000000000000000000000000000000000000000000000000000011011011011111001100010010
00000000000000000000000000000000000000000000000000000111111111001111011100010010
00000000000000000000000000000000000000000000000000000100011110001110011000011010
00000000000000000000000000000000000000000000000000000000001111000000111100001110
00000000000000000000000000000000000000000000000000000000000111100011111110001110
00000000000000000000000000000000000000000000000000000000000111110111111100001110
00000000000000000000000000000000000000000000000000001111100111111110011100111110
00000000000000000000000000000000000000000000000000001100000111111100001110100010
00000000000000000000000000000000000000000000000000011100001110011100011100000000
00000000000000000000000000000000000000000000000000001100001100011111110000000000
00000000000000000000000000000000000000000000000000000111111110111111110000000000
00000000000000000000000000000000000000000000000000000111111111111111111110000000
00000000000000000000000000000000000000000000000000000111110011111100000000000000
00000000000000000000000000000000000000000000000000000111000001000000000000000000
00000000000000000000000000000000000000000000000000000000000011000000000000000000
00000000000000000000000000000000000000000000000000000000000000000000000000000000
