80 80
00000000000000000000000000000000000000000000000000000000000000000000000000000000
00000000000000000000000000000000000000000000000000000011101111111111011000111000
00000000000000000000000000000000000000000000000000000011111111100001111000111000
00000000000000000000000000000000000000000000000000001111111111011001111000111000
00000000000000000000000000000000000000000000000000110111100111001111111000111000
00000000000000000000000000000000000000000000000000110011100111001111111100111000
00000000000000000000000000000000000000000000000000100011110111111111111111111000
00000000000000000000000000000000000000000000000000110011100000111111100110111000
00000000000000000000000000000000000000000000000001111111100000111110001110011110
00000000000000000000000000000000000000000000000001111111111111111110011100011110
00000000000000000000000000000000000000000000000001111111111111111110111100111110
00000000000000000000000000000000000000000000000000111111111111111111111100111000
00000000000000000000000000000000000000000000000001111100111001100111111110111000
00000000000000000000000000000111000000000000000001111000111001000011001111011000
00000000000000000000000000000011000000000000011001111001111111000111111011011000
00000000000000000000000000000011000000000000111001111011111111001111111111111000
00000000000000000000000000000110000000100011110000111111001110011001101111100000
00000000000000000000000000011110000000100001100000011110000000010000000000000000
00000000000000000000000000000011000001100001000000011000000000000000000000000000
00000000000000000000000001110011110011111111110000010000000000000000000000000000
00000000000000000000000011111111111111111111111001110000000000000000000000000000
00000000000000000000000111011111111000111110001111000000000000000000000000000000
00000000000000000000000100000010000000111100000000000000000000000000000000000000
00000000000000000000000000000011110000111100000000000000000000000000000000000000
00000000000000000000000000000011011101111111100000111000000000000000000000000000
00000000000000000000000000000010001111111101111111111100000000000000000000000000
00000000000000000000000000000110001111121100011111100000000000000000000000000000
00000000000000000000000000011110001111111100011000000000000000000000000000000000
00000000000000000000000000000111111111111111110000000000000000000000000000000000
00000000000000000000000000000011111111011111110000000000000000000000000000000000
00000000000000000000000000000011111111011100111000000000000000000000000000000000
00000000000000000000000000000110011100111000010000000000000000000000000000000000
00000000000000000000000000000100011100100000000000000000000000000000000000000000
00000000000000000000000000000000011100000000000000000000000000000000000000000000
00000000000000000000000000000000000100000000000000000000000000000000000000000000
00000000000000000000000000000000000100000000000000000000000000000000000000000000
00000000000000000000000000000000000000000000000000000000000000000000000000000000
00000000000000000000000000000000000000000000000000000000000000000000000000000000
00000000000000000000000000000000000000000000000000000000000000000000000000000000
00000000000000000000000000000000000000000000000000000000000000000000000000000000
00000000000000000000000000000000000000000000000000000000000000000000000000000000
00000000000000000000000000000000000000000000000000000000000000000000000000000000
00000000000000000000000000000000000000000000000000000000000000000000000000000000
00000000000000000000000000000000000000000000000000000000000000000000000000000000
00000000000000000000000000000000000000000000000000000000000000000000000000000000
00000000000000000000000000000000000000000000000000000000000000000000000000000000
00000000000000000000000000000000000000000000000000000000000000000000000000000000
00000000000000000000000000000000000000000000000000000000000000000000000000000000
00000000000000000000000000000000000000000000000000000000000000000000000000000000
00000000000000000000000000000000000000000000000000000000000000000000000000000000
00000000000000000000000000000000000000000000000000000000000000000000000000000000
00000000000000000000000000000000000000000000000000000000000000000000000000000000
00000000000000000000000000000000000000000000000000000000000000000000000000000000
00000000000000000000000000000000000000000000000000000000000000000000000000000000
00000000000000000000000000000000000000000000000000000000000000000000000000000000
00000000000000000000000000000000000000000000000000000000000000000000000000000000
00000000000000000000000000000000000000000000000000000000000000000000000000000000
00000000000000000000000000000000000000000000000000000000000000000000000000000000
00000000000000000000000000000000000000000000000000000000000000000000000000000000
00000000000000000000000000000000000000000000000000000000000000000000000000000000
00000000000000000000000000000000000000000000000000000000000000000000000000000000
00000000000000000000000000000000000000000000000000000000000000000000000000000000
00000000000000000000000000000000000000000000000000000000000000000000000000000000
00000000000000000000000000000000000000000000000000000000000000000000000000000000
00000000000000000000000000000000000000000000000000000000000000000000000000000000
00000000000000000000000000000000000000000000000000000000000000000000000000000000
00000000000000000000000000000000000000000000000000000000000000000000000000000000
00000000000000000000000000000000000000000000000000000000000000000000000000000000
00000000000000000000000000000000000000000000000000000000000000000000000000000000
00000000000000000000000000000000000000000000000000000000000000000000000000000000
00000000000000000000000000000000000000000000000000000000000000000000000000000000
00000000000000000000000000000000000000000000000000000000000000000000000000000000
00000000000000000000000000000000000000000000000000000000000000000000000000000000
00000000000000000000000000000000000000000000000000000000000000000000000000000000
00000000000000000000000000000000000000000000000000000000000000000000000000000000
00000000000000000000000000000000000000000000000000000000000000000000000000000000
00000000000000000000000000000000000000000000000000000000000000000000000000000000
00000000000000000000000000000000000000000000000000000000000000000000000000000000
00000000000000000000000000000000000000000000000000000000000000000000000000000000
00000000000000000000000000000000000000000000000000000000000000000000000000000000
