80 80
00000000000000000000000000000000000000000000000000000000000000000000000000000000
00000000000000000000000000000000000000000000000000000000000000000000000000000000
00000000000000000000000000000000000000000000000000000000000000000000000000000000
00000000000000000000000000000000000000000000000000000000000000000000000000000000
00000000000000000000000000000000000000000000000000000000000000000000000000000000
00000000000000000000000000000000000000000000000000000000000000000000000000000000
00000000000000000000000000000000000000000000000000000000000000000000000000000000
00000000000000000000000000000000000000000000000000000000000000000000000000000000
00000000000000000000000000000000000000000000000000000000000000000000000000000000
00000000000000000000000000000000000000000000000000000000000000000000000000000000
00000000000000000000000000000000000000000000000000000000000000000000000000000000
00000000000000000000000000000000000000000000000000000000000000000000000000000000
00000000000000000000000000000000000000000000000000000000000000000000000000000000
00000000000000000000000000000000000000000000000000000000000000000000000000000000
00000000000000000000000000000000000000000000000000000000000000000000000000000000
00000000000000000000000000000000000000000000000000000000000000000000000000000000
00000000000000000000000000000000000000000000000000000000000000000000000000000000
00000000000000000000000000000000000000000000000000000000000000000000000000000000
00000000000000000000000000000000000000000000000000000000000000000000000000000000
00000000000000000000000000000000000000000000000000000000000000000000000000000000
00000000000000000000000000000000000000000000000000000000000000000000000000000000
00000000000000000000000000000000000000000000000000000000000000000000000000000000
00000000000000000000000000000000000000000000000000000000000000000000000000000000
00000000000000000000000000000000000000000000000000000000000000000000000000000000
00000000000000000000000000000000000000000000000000000000000000000000000000000000
00000000000000000000000000000000000000000000000000000000000000000000000000000000
00000000000000000000000000000000000000000000000000000000000000000000000000000000
00000000000000000000000000000000000000000000000000000000000000000000000000000000
00000000000000000000000000000000000000000000000000000000000000000000000000000000
00000000000000000000000000000000000000000000000000000000000000000000000000000000
00000000000000000000000000000000000000000000000000000000000000000000000000000000
00000000000000000000000000000000000000000000000000000000000000000000000000000000
00000000000000000000000000000000000000000000000000000000000000000000000000000000
00000000000000000000000000000000000000000000000000000000000000000000000000000000
00000000000000000000000000000000000000000000000000000000000000000000000000000000
00000000000000000000000000000000000000000000000000000000000000000000000000000000
00000000000000000000000000000000000000000000000000000000000000000000000000000000
00000000000000000000000000000000000000000000000000000000000000000000000000000000
00000000000000000000000000000000000000000000000000000000000000000000000000000000
00000000000000000000000000000000000000000000000000000000000000000000000000000000
00000000000000000000000000000000000000000000000000000000000000000000000000000000
00000000000000000000000000000000000000000000000000000000000000000000000000000000
00000000000000000000000000000000000000000000000000000000000000000000000000000000
00000000000000000000000000000000000000000000100000100000011000000000000000000000
00000000000000000000000000000000000000000000110000100001110010000000000000000000
00000000000000000000000000000000000000000000010000100001111010000000000000000000
00000000000000000000000000000000000000000000010000110011011110000000000000000000
00000000000000000000000000000000000000010000110000011111001100000000000000000000
00000000000000000000011000000000000000011001110000000110000110000000000000000000
00000000000000000000110000000000000000011111110001100011000011000000000000000000
00000000000000000000100000000000000000011111111001110011100110000000000000000000
00000000000000000000100000000000000010011100011111110001100110000000000000000000
00000000000000001001100000000000000011100000001111000011100110000000000000000000
00000000000000001111100000000000000111110000011110001111100110100000000000000000
00000000000001001111100001000010011111111000111111111111100011100000000000000000
00000000001111111101110011100111111110011101111111111111100011110100000000000000
00000000000111111100110011000010001110001111111011111111010110111100000000000000
00000000000111100110111111000000000110000111111011111111110111111000000000000000
00000000001111111111111111000110000110000111111111111111001111110000000000000000
00000000001001111111111111000110000110001110111111111011110010001000000000000000
00000000001011111001111011100111001110011100111111111111110010001110000000000000
00000000001111110001110001100011011100111000111111111111110010000010000000000000
00000000001111110000000001100011111111111101111111000111110011111110000000000000
00000000111110011110000001100011111111111111111111000111110000000000000000000000
00000001111110011111110001100011111121111100110001100111011100000000000000000000
00001111011111110011111011100111111111111100010001111111111111000000000000000000
00011000001111110001111111000110111111111100110000111101110011000000000000000000
01110000000001111011111111001110010000111111110000011100011111100000000000000000
01111111000001111111111111001110011000011111100000011000000011110000000000000000
00011100100011111101111111100110001100011111100000110000000001110000000000000000
00001110111111111101111111100111001110111111111000100000000000000000000000000000
00000010000000111100111111100011100110111000001111100000000000000000000000000000
00000000000000011100111101110000111100000000000110000000000000000000000000000000
00000000000000001111110001111000001100000000001100000000000000000000000000000000
00000000000000001111100011111100001110000000000110000000000000000000000000000000
00000000000000111000100011100111111111111100000010000000000000000000000000000000
00000000000000000000110000100001111110000000000000000000000000000000000000000000
00000000000000000000000000000000000000000000000000000000000000000000000000000000
00000000000000000000000000000000000000000000000000000000000000000000000000000000
00000000000000000000000000000000000000000000000000000000000000000000000000000000
