80 80
00000000000000000000000000000000000000000000000000000000000000000000000000000000
00000000000000000000110011110000000000011101111111111111011111111100000000000000
00000000000000000000011111110000000000001111111111111100000000011100000000000000
01100100000000000001100111110000000110001100111111110100000001111100000000000000
01001100001100010000100011111111111110011100111101110011000011111100000000000000
01001110011110111111110011111111111111011100111001100001100111111100000000000000
01001111111111111111110011111111111111011100111101100001100110111100000000000000
01000111110000111110111110011101111111001111111111110011100111000100000000000000
01111111110000011000110111001110111111001111111100111111100110000000000000000000
01111110111000011000110011000111111111111111111000110111111110000000000000000000
01111110011100010000100011100111111111111111111000110111111111000000000000000000
01111110011100011001100001100111111111111001111001100111100000000000000000000000
01111110011100011001110011101111111111111001110000111100000000000000000000000000
01111111111100011111111111011111111111011111100000011000000000000000000000000000
01111111111100011111111111011111111110011111110000011100000000000000000000000000
01111110111111111111111011111112111110011111111011111000000000000000000000000000
00111110001111111111110001111111111110011111111111000000000000000000000000000000
00011100000000000010000011111111111100011111111110000000000000000000000000000000
00011000000000000011101111111111111100011110111111110000000000000000000000000000
01111111111111110001111111111111111100111100011001100000100000000000000000000000
01111111111111111001111111111111001111111100111000110011110000000000000000000000
01111111111111111001111110000110000011111100110000111110010000000000000000000000
01111111111110011111111100000110000000111111100001100100000000000000000000000000
01111111111110011111111100001111000001110011011111000000000000000000000000000000
01111111111110111111111110011111000111111110011111000000000000000000000000000000
01111111111100111011111111111111000100111110110001110000000000000000000000000000
01111111111000111011111000111111001100011100110000000000000000000000000000000000
01111000000001111111111000011100011000000011100000000000000000000000000000000000
00011000000111111111111000111000000000000111100000000000000000000000000000000000
00001100001111111111111101111100000000001100110000000000000000000000000000000000
00001110011100111111111111111111000000011000010000000000000000000000000000000000
00000110011000111101111101011001000000110000011100000000000000000000000000000000
00000001111100111111111000010000000000100000000100000000000000000000000000000000
00000000111111111111100000110000000000000000000100000000000000000000000000000000
00000100011111111111100011110011000000000000000100000000000000000000000000000000
00001111011101111111111011110111000000000000000000000000000000000000000000000000
00000111111101111110000001111110000000000000000000000000000000000000000000000000
00000001111000111100000000011000000000000000000000000000000000000000000000000000
00000011110000111000000000010000000000000000000000000000000000000000000000000000
00000111111000110010000000110000000000000000000000000000000000000000000000000000
01001110011110111111110011100000000000000000000000000000000000000000000000000000
01001100001110011111110001000000000000000000000000000000000000000000000000000000
01111100001111111011000001110000000000000000000000000000000000000000000000000000
01111111111111111000000111000000000000000000000000000000000000000000000000000000
01111111111111111000011111000000000000000000000000000000000000000000000000000000
01011111111111111001111001000000000000000000000000000000000000000000000000000000
00011111111111111111000001100000000000000000000000000000000000000000000000000000
00001111111100000000000111000000000000000000000000000000000000000000000000000000
00001101111000000000000001000000000000000000000000000000000000000000000000000000
01011110011000110000100000000000000000000000000000000000000000000000000000000000
01111110001100111111110000000000000000000000000000000000000000000000000000000000
01111110001111011111111100000000000000000000000000000000000000000000000000000000
01111110000111000110111000000000000000000000000000000000000000000000000000000000
01111111000001100000010000000000000000000000000000000000000000000000000000000000
01001111110000111000010000000000000000000000000000000000000000000000000000000000
01111111111110111001111000000000000000000000000000000000000000000000000000000000
01111111101111111111000000000000000000000000000000000000000000000000000000000000
01111111100110001110000000000000000000000000000000000000000000000000000000000000
01111111111111000010000000000000000000000000000000000000000000000000000000000000
01111110111000000000000000000000000000000000000000000000000000000000000000000000
01111100111100000000000000000000000000000000000000000000000000000000000000000000
01111110101100000000000000000000000000000000000000000000000000000000000000000000
01111111101100000000000000000000000000000000000000000000000000000000000000000000
00111111011100000000000000000000000000000000000000000000000000000000000000000000
01111110011000000000000000000000000000000000000000000000000000000000000000000000
01101100001100000000000000000000000000000000000000000000000000000000000000000000
00001100001100000000000000000000000000000000000000000000000000000000000000000000
00001000000000000000000000000000000000000000000000000000000000000000000000000000
00000000000000000000000000000000000000000000000000000000000000000000000000000000
00000000000000000000000000000000000000000000000000000000000000000000000000000000
00000000000000000000000000000000000000000000000000000000000000000000000000000000
00000000000000000000000000000000000000000000000000000000000000000000000000000000
00000000000000000000000000000000000000000000000000000000000000000000000000000000
00000000000000000000000000000000000000000000000000000000000000000000000000000000
00000000000000000000000000000000000000000000000000000000000000000000000000000000
00000000000000000000000000000000000000000000000000000000000000000000000000000000
00000000000000000000000000000000000000000000000000000000000000000000000000000000
00000000000000000000000000000000000000000000000000000000000000000000000000000000
00000000000000000000000000000000000000000000000000000000000000000000000000000000
00000000000000000000000000000000000000000000000000000000000000000000000000000000
