80 80
00000000000000000000000000000000000000000000000000000000000000000000000000000000
00000000000000000000000000000000000000000000000000000000000000000000000000000000
00000000000000000000000000000000000000000000000000000000000000000000000000000000
00000000000000000000000000000000000000000000000000000000000000000000000000000000
00000000000000000000000000000000000000000000000000000000000000000000000000000000
00000000000000000000000000000000000000000000000000000000000000000000000000000000
00000000000000000000000000000000000000000000000000000000000000000000000000000000
00000000000000000000000000000000000000000000000000000000000000000000000000000000
00000000000000000000000000000000000000000000000000000000000000000000000000000000
00000000000000000000000000000000000000000000000000000000000000000000000000000000
00000000000000000000000000000000000000000000000000000000000000000000000000000000
00000000000000000000000000000000000000000000000000000000000000000000000000000000
00000000000000000000000000000000000000000000000000000000000000000000000000000000
00000000000000000000000000000000000000000000000000000000000000000000000000000000
00000000000000000000000000000000000000000000000000000000000000000000000000000000
00000000000000000000000000000000000000000000000000000000000000000000000000000000
00000000000000000000000000000000000000000000000000000000000000000000000000000000
00000000000000000000000000000000000000000000000000000000000000000000000000000000
00000000000000000000000001000000000000000000000000000000000000000000000000000000
00000000000000000000000001100001000000000000000000000000000000000000000000000000
00000000000000000000110111110111000000000000000000000000000000000000000000000000
00000000000000000000011111111110000000000000000000000000000000000000000000000000
00000000000000000000011111001110001000010000000000000000000000000000000000000000
00000000000000000011111111000110111000111000000000000000000000000000000000000000
00000000000000000000111111100011111111001100000000000000000000000000000000000000
00000000000000010000111111100011111111111100000000000000000000000000000000000000
00000000000000010000111111100010001111110000000000000000000000000000000000000000
00000000000000110000111111100110000111100000000000000000000000000000000000000000
00000000000000011000011110001100100111000000000000100000000000000000000000000000
00000000101000010000011111000100101110000000000000110000000000000000000000000000
00000000111000010001110011000011101110011100011001110000000000000000000000000000
00000000111100110000000000000001101110111000001111110000000000000000000000000000
00000001101111100000000000001111111111111100001111110001000000000000000000000000
00000001001111100100000000000000100111111110011111111111000000000000000000000000
00000000001111111111000000000000110111111111111111111110000000000000000000000000
00000000011111111111100000000000001110111111111111111111100000000000000000000000
00000000011111121111110000000000001100001111111111111000000000000000000000000000
00000000011111111111110000000000000000001111111111111000000000000000000000000000
00000000011111111111111000000000000000001111111001111111000000000000000000000000
00000000001111111111111100000000000000011111111001111111000000000000000000000000
00000000001111111111111100000000000000011111111001111111000000000000000000000000
00000000001100111111111100000000000000011100011100111111000000000000000000000000
00000000001100001111111000000000000000001100001100001100000000000000000000000000
00000000000000000111110001000000000000011000001100000000000000000000000000000000
00000000000000000011110011000000000000011001111100000000000000000000000000000000
00000000000000000001111111000000000111111101111101100000000000000000000000000000
00000000000000000001111111100000000011001100111111000000000000000000000000000000
00000000000000000111111111110000000111000100011110000000000000000000000000000000
00000000000000000001111111100110001110000000011111000000000000000000000000000000
00000000000000000100111011101111000100000000010011100000000000000000000000000000
00000000000000011111110011101111000100000000011011110000000000000000000000000000
00000000000000000011100001111111000100000000011111110000000000000000000000000000
00000000000000000011100000111111100110000000001111100000000000000000000000000000
00000000000000000001111000011111110011000000001001100000000000000000000000000000
00000000000000000000001100111111111110000000000000000000000000000000000000000000
00000000000000000001111111111111111110000000000000000000000000000000000000000000
00000000000000000000011000000111111100010000000000000000000000000000000000000000
00000000000000000000001000000111000000010000000000000000000000000000000000000000
00000000000000000000000000000111000011010000000000000000000000000000000000000000
00000000000000000000000001111111000110011000000000000000000000000000000000000000
00000000000000000000000011111111000110011100000000000000000000000000000000000000
00000000000000000000000011111111000110111100000000000000000000000000000000000000
00000000000000000000000010011110000111111100000000000000000000000000000000000000
00000000000000000000000000011110111111110000000000000000000000000000000000000000
00000000000000000000000001111111111111111000000000000000000000000000000000000000
00000000000000000000000011111111011111111100000000000000000000000000000000000000
00000000000000000000000111001011111110001100000000000000000000000000000000000000
00000000000000000000000100000011110100000110000000000000000000000000000000000000
00000000000000000000000100000011000000001110000000000000000000000000000000000000
00000000000000000000000111000010000010001101100000000000000000000000000000000000
00000000000000000001110111100010000111011101111000000000000000000000000000000000
00000000000000000000111101110010000001111111001100000000000000000000000000000000
00000000000000000000010000011100000000111110000100000000000000000000000000000000
00000000000000000000110000000000000000111100000100000000000000000000000000000000
00000000000000000011100001000000000000011000000100000000000000000000000000000000
00000000000000000001110011000000000111111000111100000000000000000000000000000000
00000000000000000000110001100000000001111000000000000000000000000000000000000000
00000000000000000000011001111000000000000000000000000000000000000000000000000000
00000000000000000000011111100000000000000000000000000000000000000000000000000000
00000000000000000000000000000000000000000000000000000000000000000000000000000000
