80 80
00000000000000000000000000000000000000000000000000000000000000000000000000000000
00000000000000000000000000000000000000000000000000000000000000000000000000000000
00000000000000000000000000000000000000000000000000000000000000000000000000000000
00000000000000000000000000000000000000000000000000000000000000000000000000000000
00000000000000000000000000000000000000000000000000000000000000000000000000000000
00000000000000000000000000000000000000000000000000000000000000000000000000000000
00000000000000000000000000000000000000000000000000000000000000000000000000000000
00000000000000000000000000000000000000000000000000000000000000000000000000000000
00000000000000000000000000000000000000000000000000000000000000000000000000000000
00000000000000000000000000000000000000000000000000000000000000000000000000000000
00000000000000000000000000000000000000000000000000000000000000000000000000000000
00000000000000000000000000000000000000000000000000000000000000000000000000000000
00000000000000000000000000000000000000000000000000000000000000000000000000000000
00000000000000000000000000000000000000000000000000000000000000000000000000000000
00000000000000000000000000000000000000000000000000000000000000000000000000000000
00000000000000000000000000000000000000000000000000000000000000000000000000000000
00000000000000000000000000000000000000000000000000000000000000000000000000000000
00000000000000000000000000000000000000000000000000000000000000000000000000000000
00000000000000000000000000000000000000000000000000000000000000000000000000000000
00000000000000000000000000000000000000000000000000000000000000000000000000000000
00000000000000000000000000000000000000000000000000000000000000000000000000000000
00000000000000000000000000000000000000000000000000000000000000000000000000000000
00000000000000000000000000000000000000000000000000000000000000000000000000000000
00000000000000000000000000000000000000000000000000000000000000000000000000000000
00000000000000000000000000000000000000000000000000000000000000000000000000000000
00000000000000000000000000000000000000000000000000000000000000000000000000000000
00000000000000000000000000000000000000000000000000000000000000000000000000000000
00000000000000000000000000000000000000000000000000000000000000000000000000000000
00000000000000000000000000000000000000000000000000000000000000000000000000000000
00000000000000000000000000000000000000000000000000000000000000000000000000000000
00000000000000000000000000000000000000000000000000000000000000000000000000000000
00000000000000000000000000000000000000000000000000000000000000000000000000000000
00000000000000000000000000000000000000000000000000000000000000000000000000000000
00000000000000000000000000000000000000000000000000000000000000000000000000000000
00000000000000000000000000000000000000000000000000000000000000000000000000000000
00000000000000000000000000000000000000000000000000000000000000000000000000000000
00000000000000000000000000000000000000000000000000000000000000000000000000000000
00000000000000000000000000000000000000000000000000000000000000000000000000000000
00000000000000000000000000000000000000000000000000000000000000000000000000000000
00000000000000000000000000000000000000000000000000000000000000000000000000000000
00000000000000000000000000000000000000000000000000000000000000000000000000000000
00000000000000000000000000000000000000000000000000000000000000000000000000000000
00000000000000000000000000000000000000000000000000000000000000000000000000000000
00000000000000000000000000000000000000000000000000000000000000000000000000000000
00000000000000000000000000000000000000000000000000000000000000000000000000000000
00000000000000000000000000000000000000000000000000000000000000000000000000000000
00000000000000000000000000000000000000000000000000000000000000000000000000000000
00000000000000000000000000000000000000000000000000000000000000000000000000000000
00000000000000000000000000000000000000000000000000000000010000000000000000000000
00000000000000000000000000000000000000000000001000000000010000000000000000000000
00000000000000000000000000000000000000000000011000000011111110000000000000000000
00000000000000000000000000000000000000000000111000000000110110000000000000000000
00000000000000000000000100000000000000000001111000011100001111001000000000000000
00000000000000000000000100000000000000000011110000001111000111111000000000000000
00000000000000000000000111100000000000001111110000001111100111001110011000000000
00000000000000000000000111110000000000111100110000111111111111111110011000000000
00000000000000000000000001111000000001111000011000000011111111111110001100000000
00000000000000000000000001110000000000110000001100000011111111111110001100000000
00000000000000000000000001000000000000011000000100000011111112111111101100000000
00000000000000000000000001001100000000001000011111000111111111111111111000000000
00000000000000000000000001000111000000001000111001111111111111111111111000000000
00000000000000000000001001000111000000001100110000111111111111111111110000000000
00000000000000000000001111111111000010001111110000011111110011101111000000000000
00000000000000000010011111111111000011000011111111111111100000100110000000000000
00000000000000011111111111100111000111111000011111111011100000100010000000000000
00000000000000111111110011100111001111111100111111111011100011110000000000000000
00000000000000110111100011111110011111101100111111111011000000011000000000000000
00000000000000000111100011111100011111100000111111111111000000010000000000000000
00000000000000000111100111111100011111000000111111111111000000010000000000000000
00000000000000000001101111111111111110111000111111111111000000010000000000000000
00000000000000000000111111111111101111111100111111111011101111100000000000000000
00000000000000000001100000011111000111111111111111110001111000110000000000000000
00000000000000000000000000001000000111000011110000000001110000010000000000000000
00000000000000000000000000001100000111100011110000000111100000000000000000000000
00000000000000000000000000001110000100110111111011111111000000000000000000000000
00000000000000000000000011111111000100011110111111111111100000000000000000000000
00000000000000000000000000001011000000000000111111110001100000000000000000000000
00000000000000000000000000000000000000000000111111110000000000000000000000000000
00000000000000000000000000000000000000000000111111110000000000000000000000000000
00000000000000000000000000000000000000000000000000000000000000000000000000000000
