80 80
00000000000000000000000000000000000000000000000000000000000000000000000000000000
00000000011001011111100111100011001111000001100000000000000000000000000000000000
00000000011011001111101111100011111111000001000011000000000000000000000000000000
00000000101110011001111111111110001111000001000111000000000000000000000000000000
00000001101111111001111111111110001110110011111111100000000000000000000000000000
00000000111111111000111111111111000110111111111111111111100000000000000000000000
00000000011111111000111111111011000110001111111100000000000000000000000000000000
00000000011111111101100000011111100111000111110000000000000000000000000000000000
00000000111000111111000000001111111111111111100000000000000000000000000000000000
00000000111000111111110001100111111111111111110000100000000000000000000000000000
00000000101000111111110111111111001111112111111111111111100000000000000000000000
00000000000000011111111111111110000111111111011111111100110000000000000000000000
00000000000000000011111100011111011111111111000000000000010000000000000000000000
00000000000000000011101100000111111100011111000000000000010000000000000000000000
00000000000000000011011111000111111100001111110011100000110000000000000000000000
00000000000000111111110001001111111111111111111111110011111111100000000000000000
00000000000000000000000001111111100111111111111111110011111100100000000000000000
00000000000000000000000000000111100001100011011111101111111100000000000000000000
00000000000000000000000000000011100001100111110011100111011110000000000000000000
00000000000000000000000000000011100011111111110001100111001111000000000000000000
00000000000000000000000000000111111111111111111001110011111111100000000000000000
00000000000000000000000000000000001000001110011100110001111011100000000000000000
00000000000000000000000000000000001000000000000100111100011011000000000000000000
00000000000000000000000000000000001000000000001110000111001111000000000000000000
00000000000000000000000000000000000000000000011111100011001110000110000000000000
00000000000000000000000000000000000000000000011111110001100111000100000000000000
00000000000000000000000000000000000000000000110110110001110011101100000000000000
00000000000000000000000000000000000000000000000010111011100011111110000000000000
00000000000000000000000000000000000000000000000000111111100011110110000000000000
00000000000000000000000000000000000000000000000000110011000011110110000000000000
00000000000000000000000000000000000000000000000001100001000011111100000000000000
00000000000000000000000000000000000000000000000001000001000011111100000000000000
00000000000000000000000000000000000000000000000000000000000011100000000000000000
00000000000000000000000000000000000000000000000000000000000001110000000000000000
00000000000000000000000000000000000000000000000000000001000111111000000000000000
00000000000000000000000000000000000000000000000000000001101111001110000000000000
00000000000000000000000000000000000000000000000000000001111101000010000000000000
00000000000000000000000000000000000000000000000000000000110000000000000000000000
00000000000000000000000000000000000000000000000000000000000000000000000000000000
00000000000000000000000000000000000000000000000000000000000000000000000000000000
00000000000000000000000000000000000000000000000000000000000000000000000000000000
00000000000000000000000000000000000000000000000000000000000000000000000000000000
00000000000000000000000000000000000000000000000000000000000000000000000000000000
00000000000000000000000000000000000000000000000000000000000000000000000000000000
00000000000000000000000000000000000000000000000000000000000000000000000000000000
00000000000000000000000000000000000000000000000000000000000000000000000000000000
00000000000000000000000000000000000000000000000000000000000000000000000000000000
00000000000000000000000000000000000000000000000000000000000000000000000000000000
00000000000000000000000000000000000000000000000000000000000000000000000000000000
00000000000000000000000000000000000000000000000000000000000000000000000000000000
00000000000000000000000000000000000000000000000000000000000000000000000000000000
00000000000000000000000000000000000000000000000000000000000000000000000000000000
00000000000000000000000000000000000000000000000000000000000000000000000000000000
00000000000000000000000000000000000000000000000000000000000000000000000000000000
00000000000000000000000000000000000000000000000000000000000000000000000000000000
00000000000000000000000000000000000000000000000000000000000000000000000000000000
00000000000000000000000000000000000000000000000000000000000000000000000000000000
00000000000000000000000000000000000000000000000000000000000000000000000000000000
00000000000000000000000000000000000000000000000000000000000000000000000000000000
00000000000000000000000000000000000000000000000000000000000000000000000000000000
00000000000000000000000000000000000000000000000000000000000000000000000000000000
00000000000000000000000000000000000000000000000000000000000000000000000000000000
00000000000000000000000000000000000000000000000000000000000000000000000000000000
00000000000000000000000000000000000000000000000000000000000000000000000000000000
00000000000000000000000000000000000000000000000000000000000000000000000000000000
00000000000000000000000000000000000000000000000000000000000000000000000000000000
00000000000000000000000000000000000000000000000000000000000000000000000000000000
00000000000000000000000000000000000000000000000000000000000000000000000000000000
00000000000000000000000000000000000000000000000000000000000000000000000000000000
00000000000000000000000000000000000000000000000000000000000000000000000000000000
00000000000000000000000000000000000000000000000000000000000000000000000000000000
00000000000000000000000000000000000000000000000000000000000000000000000000000000
00000000000000000000000000000000000000000000000000000000000000000000000000000000
00000000000000000000000000000000000000000000000000000000000000000000000000000000
00000000000000000000000000000000000000000000000000000000000000000000000000000000
00000000000000000000000000000000000000000000000000000000000000000000000000000000
00000000000000000000000000000000000000000000000000000000000000000000000000000000
00000000000000000000000000000000000000000000000000000000000000000000000000000000
00000000000000000000000000000000000000000000000000000000000000000000000000000000
00000000000000000000000000000000000000000000000000000000000000000000000000000000
