80 80
00000000000000000000000000000000000000000000000000000000000000000000000000000000
00000000000000000000000000000000000000000000000000000000000000000000000000000000
00000000000000000000000000000000000000000000000000000000000000000000000000000000
00000000000000000000000000000000000000000000000000000000000000000000000000000000
00000000000000000000000000000000000000000000000000000000000000000000000000000000
00000000000000000000000000000000000000000000000000000000000000000000000000000000
00000000000000000000000000000000000000000000000000000000000000000000000000000000
00000000000000000000000000000000000000000000000000000000000000000000000000000000
00000000000000000000000000000000000000000000000000000000000000000000000000000000
00000000000000000000000000000000000000000000000000000000000000000000000000000000
00000000000000000000000000000000000000000000000000000000000000000000000000000000
00000000000000000000000000000000000000000000000000000000000000000000000000000000
00000000000000000000000000000000000000000000000000000000000000000000000000000000
00000000000000000000000000000000000000000000000000000000000000000000000000000000
00000000000000000000000000000000000000000000000000000000000000000000000000000000
00000000000000000000000000000000000000000000000000000000000000000000000000000000
00000000000000000000000000000000000000000000000000000000000000000000000000000000
00000000000000000000000000000000000000000000000000000000000000000000000000000000
00000000000000000000000000000000000000000000000000000000000000000000000000000000
00000000000000000000000000000000000000000000000000000000000000000000000000000000
00000000000000000000000000000000000000000000000000000000000000000000000000000000
00000000000000000000000000000000000000000000000000000000000000000000000000000000
00000000000000000000000000000000000000000000000000000000000000000000000000000000
00000000000000000000000000000000000000000000000000000000000000000000000000000000
00000000000000000000000000000000000000000000000000000000000000000000000000000000
00000000000000000000000000000000000000000000000000000000000000000000000000000000
00000000000000000000000000000000000000000000000000000000000000000000000000000000
00000000000000000000000000000000000000000000000000000000000000000000000000000000
00000000000000000000000000000000000000000000000000000000000000000000000000000000
00000000000000000000000000000000000000000000000000000000000000000000000000000000
00000000000000000000000000000000000000000000000000000000000000000000000000000000
00000000000000000000000000000000000000000000000000000000000000000000000000000000
00000000000000000000000000000000000000000000000000000000000000000000000000000000
00000000000000000000000000000000000000000000000000000000000000000000000000000000
00000000000000000000000000000000000000000000000000000000000000000000000000000000
00000000000000000000000000000000000000000000000000000000000000000000000000000000
00000000000000000000000000000000000000000000000000000000000000000000000000000000
00000000000000000000000000000000000000000000000000000000000000000000000000000000
00000000000000000000000000000000000000000000000000000000000000000000000000000000
00000000000000000000000000000000000000000000000000000000000000000000000000000000
00000000000000000000000000000000000000000000000000000000000000000000000000000000
00000000000000000000000000000000000000000000000000000000000000000000000000000000
00000000000000000000000000000000000000000000000000000000000000000000000000000000
00000000000000000000000000000000000000000000000000000000000000000000000000000000
00000000000000000000000000000000000000000000000000000000000000000000000000000000
00000000000000000000000000000000000000000000000000000000000000000000000000000000
00000000000000000000000000000000000000000000000000000000000000000000000000000000
00000000000000000000000000000000000000000000000000000000000000000000000000000000
00000000000000000000000000000111000000000000000000000000000000000000000000000000
00000000000000000000000000000100000100000000010000000000000000000000000000000000
00000000000000000000000000000111000100000000011100000000000000000000000000000000
00000000000000000000000000000001000100000000110110000000000000000000000000000000
00000000000000000000000000000001111111000011110110000000000000000000000000000000
00000000000000000000000000000001111110000111000000000000000000000000000000000000
00000000000000000000000000000011110110001100001000000000000000000000000000000000
00000000000000000000000011100011111100011100111000000000000000000000000000000000
00000000000000000000000001100110111100011001100000000000000000000000000000000000
00000000000000000000000000111100111110011111000000000000000000000000000000000000
00000000000000000000001100100001100111111100000000000000000000000000000000000000
00000000000000000001001111000011000111011000000000000000000000000000000000000000
00000000000000000001111111100011001111011100000000000000000000000000000000000000
00000000000000000000011111100110001111001100000000000000000000000000000000000000
00000000000000000000001111101110011111111100000000000000000000000000000000000000
00000000000000000000001111111011100111101111000000000000000000000000000000000000
00000000000000000001111111110011000111111101110000000000000000000000000000000000
00000000000000000001111111111111000111111100110000000000000000000000000000000000
00000000000000000000111111111110001101111000010000000000000000000000000000000000
00000000000000000000111121111110001111110000010000000000000000000000000000000000
00000000000000000001111111111111111111100000000000000000000000000000000000000000
00000000000000000000111111111111110110000000000000000000000000000000000000000000
00000000000000000000111111111111111100000000000000000000000000000000000000000000
00000000000000000000111111011110011000000000000000000000000000000000000000000000
00000000000000000001111111001100000000000000000000000000000000000000000000000000
00000000000000000011110011000000000000000000000000000000000000000000000000000000
00000000000000000000100011000111000111100000000000000000000000000000000000000000
00000000000000000000100011111111000100000000000000000000000000000000000000000000
00000000000000000001100001101111111100000000000000000000000000000000000000000000
00000000000000000011100000000111111000000000000000000000000000000000000000000000
00000000000000000110111000000011000000000000000000000000000000000000000000000000
00000000000000000000000000000000000000000000000000000000000000000000000000000000
