80 80
00000000000000000000000000000000000000000000000000000000000000000000000000000000
00000000000000000000000000000000000000000000111000110001111111100110000000000000
00000000000000000000000000000000000000000011111000111000011001100011000000000000
00000000000000000000000000000000000000000000111100011100001111000011000000000000
00000000000000000000000000000000000000000000011111111111001110000111011110000000
00000000000000000000000000000000000000000000011111111111111111001110111111111110
00000000000000000000000000000000000000000000111111111101111011111100111100000110
00000000000000000000000000000000000000000000111000000101111111111000111000000110
00000000000000000000000000000000000000000000111000001111000111111100110000001110
00000000000000000000000000000000000000000000011001111111000111111101111110111010
00000000000000000000000000000000000000000000111001111011100111111111111101111000
00000000000000000000000000000000000000000000111001110001100011111110111111111000
00000000000000000000000000000000000000000001111111110000000011121111101111100000
00000000000000000000000000000000000000000001111111110000000011111111001100000000
00000000000000000000000000000000000000000001111111110001000011111111001100000000
00000000000000000000000000000000000000011111111111111111100011111111101000000000
00000000000000000000000000000000000000000011111111101111000110000111111000000000
00000000000000000000000000000000000000000001001111000111001000000000111000000000
00000000000000000000000000000000000000000001000011000011111000000000000000000000
00000000000000000000000000000000000000000000000001100001100000000000000000000000
00000000000000000000000000000000000000000000000011100001000000000000000000000000
00000000000000000000000000000000000000000000000000110011000000000000000000000000
00000000000000000000000000000000000000000000000000001110000000000000000000000000
00000000000000000000000000000000000000000000000000000110000001000000000000000000
00000000000000000000000000000000000000000000000001000111001011000000000000000000
00000000000000000000000000000000000000000000000001111111111111000000000000000000
00000000000000000000000000000000000000000000000000011101111110000000000000000000
00000000000000000000000000000000000000000000000000000001111111000000000000000000
00000000000000000000000000000000000000000000000000000001111011100000000000000000
00000000000000000000000000000000000000000000000000000001011010110000000000000000
00000000000000000000000000000000000000000000000000000001001110000000000000000000
00000000000000000000000000000000000000000000000000000001001000000000000000000000
00000000000000000000000000000000000000000000000000000000001000000000000000000000
00000000000000000000000000000000000000000000000000000000001100000000000000000000
00000000000000000000000000000000000000000000000000000000000000000000000000000000
00000000000000000000000000000000000000000000000000000000000000000000000000000000
00000000000000000000000000000000000000000000000000000000000000000000000000000000
00000000000000000000000000000000000000000000000000000000000000000000000000000000
00000000000000000000000000000000000000000000000000000000000000000000000000000000
00000000000000000000000000000000000000000000000000000000000000000000000000000000
00000000000000000000000000000000000000000000000000000000000000000000000000000000
00000000000000000000000000000000000000000000000000000000000000000000000000000000
00000000000000000000000000000000000000000000000000000000000000000000000000000000
00000000000000000000000000000000000000000000000000000000000000000000000000000000
00000000000000000000000000000000000000000000000000000000000000000000000000000000
00000000000000000000000000000000000000000000000000000000000000000000000000000000
00000000000000000000000000000000000000000000000000000000000000000000000000000000
00000000000000000000000000000000000000000000000000000000000000000000000000000000
00000000000000000000000000000000000000000000000000000000000000000000000000000000
00000000000000000000000000000000000000000000000000000000000000000000000000000000
00000000000000000000000000000000000000000000000000000000000000000000000000000000
00000000000000000000000000000000000000000000000000000000000000000000000000000000
00000000000000000000000000000000000000000000000000000000000000000000000000000000
00000000000000000000000000000000000000000000000000000000000000000000000000000000
00000000000000000000000000000000000000000000000000000000000000000000000000000000
00000000000000000000000000000000000000000000000000000000000000000000000000000000
00000000000000000000000000000000000000000000000000000000000000000000000000000000
00000000000000000000000000000000000000000000000000000000000000000000000000000000
00000000000000000000000000000000000000000000000000000000000000000000000000000000
00000000000000000000000000000000000000000000000000000000000000000000000000000000
00000000000000000000000000000000000000000000000000000000000000000000000000000000
00000000000000000000000000000000000000000000000000000000000000000000000000000000
00000000000000000000000000000000000000000000000000000000000000000000000000000000
00000000000000000000000000000000000000000000000000000000000000000000000000000000
00000000000000000000000000000000000000000000000000000000000000000000000000000000
00000000000000000000000000000000000000000000000000000000000000000000000000000000
00000000000000000000000000000000000000000000000000000000000000000000000000000000
00000000000000000000000000000000000000000000000000000000000000000000000000000000
00000000000000000000000000000000000000000000000000000000000000000000000000000000
00000000000000000000000000000000000000000000000000000000000000000000000000000000
00000000000000000000000000000000000000000000000000000000000000000000000000000000
00000000000000000000000000000000000000000000000000000000000000000000000000000000
00000000000000000000000000000000000000000000000000000000000000000000000000000000
00000000000000000000000000000000000000000000000000000000000000000000000000000000
00000000000000000000000000000000000000000000000000000000000000000000000000000000
00000000000000000000000000000000000000000000000000000000000000000000000000000000
00000000000000000000000000000000000000000000000000000000000000000000000000000000
00000000000000000000000000000000000000000000000000000000000000000000000000000000
00000000000000000000000000000000000000000000000000000000000000000000000000000000
00000000000000000000000000000000000000000000000000000000000000000000000000000000
