80 80
00000000000000000000000000000000000000000000000000000000000000000000000000000000
00000000000000011111111101000000000000000000000000000000000000000000000000000000
00000000000000011111101101000000000000000000000000000000000000000000000000000000
00000000000000111000001111000000000000000000000000000000000000000000000000000000
00000000001111111000111111000000000000000000000000000000000000000000000000000000
00011111111111111111110001000000000000000000000000000000000000000000000000000000
00110001111000111111000001100000000000000000000000000000000000000000000000000000
00000000111100000000000000000000000000000000000000000000000000000000000000000000
00000000111111000000000000000000000000000000000000000000000000000000000000000000
00000000011111111000010000100000000000000000000000000000000000000000000000000000
00000000011111111111111111100000000000000000000000000000000000000000000000000000
00000000001111121111100010000000000000000000000000000000000000000000000000000000
00000000100111111111100000000000000000000000000000000000000000000000000000000000
00000000110011111001100000000000000000000000000000000000000000000000000000000000
00000000011111111000100000000000000000000000000000000000000000000000000000000000
00000000011111111000100000000000000000000000000000000000000000000000000000000000
00000000001111111101100000000001000000000000000000000000000000000000000000000000
00000000000001111111110000000001000000000000000000000000000000000000000000000000
00000000000001011111111110000011100000000000000000000000000000000000000000000000
00000000111011111111111111001111100000000000000000000000000000000000000000000000
00001111111111111111111011111111100000000000000000000000000000000000000000000000
00000010011111110011111001111011100000000000000000000000000000000000000000000000
00000000011111000000011101110001100000000000000000000000000000000000000000000000
00000011111110000000011111110001000000000000000000000000000000000000000000000000
00110111111100001111111011111011000000000000000000000000000000000000000000000000
01111110111100111111110011111110000000000000000000000000000000000000000000000000
01111100111111110011110011011110000000000000000000000000000000000000000000000000
01111100111111100011110111001110000000000000000000000000000000000000000000000000
01011000110011110011111000001110000000000000000000000000000000000000000000000000
00001100011011111111111000011111110010000000000000000000000000000000000000000000
00001110011111111111110000001111111110000000000000000000000000000000000000000000
00000110001111111111100000000111001000000000000000000000000000000000000000000000
01000011000100000111100000000000000000000000000000000000000000000000000000000000
01111001100111000001100000000000000000000000000000000000000000000000000000000000
01111100111111110001100001100000000000000000000000000000000000000000000000000000
01001110111111111101100001100000000000000000000000000000000000000000000000000000
01000111111100001111100011000000000000000000000000000000000000000000000000000000
00001100010000000111110011000000000000000000000000000000000000000000000000000000
00001000000000000010110011111000000000000000000000000000000000000000000000000000
00001000011111100110111111000000000000000000000000000000000000000000000000000000
00001110011111111101111111100000000000000000000000000000000000000000000000000000
00000000011000111111100100110000000000000000000000000000000000000000000000000000
00000000011111111111101100010000000000000000000000000000000000000000000000000000
00000000011000111111101100010000000000000000000000000000000000000000000000000000
00000000011000011111110011011000000000000000000000000000000000000000000000000000
00000000011100111111110011111110000000000000000000000000000000000000000000000000
00000000000111100011111111100000000000000000000000000000000000000000000000000000
00000000000000000000001110000000000000000000000000000000000000000000000000000000
00000000000000000000000100000000000000000000000000000000000000000000000000000000
00000000000000000000000000000000000000000000000000000000000000000000000000000000
00000000000000000000000000000000000000000000000000000000000000000000000000000000
00000000000000000000000000000000000000000000000000000000000000000000000000000000
00000000000000000000000000000000000000000000000000000000000000000000000000000000
00000000000000000000000000000000000000000000000000000000000000000000000000000000
00000000000000000000000000000000000000000000000000000000000000000000000000000000
00000000000000000000000000000000000000000000000000000000000000000000000000000000
00000000000000000000000000000000000000000000000000000000000000000000000000000000
00000000000000000000000000000000000000000000000000000000000000000000000000000000
00000000000000000000000000000000000000000000000000000000000000000000000000000000
00000000000000000000000000000000000000000000000000000000000000000000000000000000
00000000000000000000000000000000000000000000000000000000000000000000000000000000
00000000000000000000000000000000000000000000000000000000000000000000000000000000
00000000000000000000000000000000000000000000000000000000000000000000000000000000
00000000000000000000000000000000000000000000000000000000000000000000000000000000
00000000000000000000000000000000000000000000000000000000000000000000000000000000
00000000000000000000000000000000000000000000000000000000000000000000000000000000
00000000000000000000000000000000000000000000000000000000000000000000000000000000
00000000000000000000000000000000000000000000000000000000000000000000000000000000
00000000000000000000000000000000000000000000000000000000000000000000000000000000
00000000000000000000000000000000000000000000000000000000000000000000000000000000
00000000000000000000000000000000000000000000000000000000000000000000000000000000
00000000000000000000000000000000000000000000000000000000000000000000000000000000
00000000000000000000000000000000000000000000000000000000000000000000000000000000
00000000000000000000000000000000000000000000000000000000000000000000000000000000
00000000000000000000000000000000000000000000000000000000000000000000000000000000
00000000000000000000000000000000000000000000000000000000000000000000000000000000
00000000000000000000000000000000000000000000000000000000000000000000000000000000
00000000000000000000000000000000000000000000000000000000000000000000000000000000
00000000000000000000000000000000000000000000000000000000000000000000000000000000
00000000000000000000000000000000000000000000000000000000000000000000000000000000
