80 80
00000000000000000000000000000000000000000000000000000000000000000000000000000000
00000000011000011011100000000000000000000000000000000000000000000000000000000000
00000001111000111011000000000000000000000000000000000000000000000000000000000000
00000000011111110010000000000000000000000000000000000000000000000000000000000000
00000000001111110111000000000000000000000000000000000000000000000000000000000000
00000000001111111111100000000000000000000000000000000000000000000000000000000000
00000000011001001000000000000000000000000000000000000000000000000000000000000000
00000000010011001000000000000000000000000000000000000000000000000000000000000000
00000010010011001000000000000000000000000000000000000000000000000000000000000000
00000111011111111000110000000000000000000000000000000000000000000000000000000000
01111110011111111001110000000000000000000000000000000000000000000000000000000000
01111100001111111111100000000000000000000000000000000000000000000000000000000000
00011100000001111111100000000000000000000000000000000000000000000000000000000000
00001111000000111111100000000000000000000000000000000000000000000000000000000000
00001111111000111111100000000000000000000000000000000000000000000000000000000000
00001111111101111101110000000000000000000000000000000000000000000000000000000000
00011111111111111000110000000000000000000000000000000000000000000000000000000000
00001111111211111111110000000000000000000000000000000000000000000000000000000000
00001111111111111000111000000000000000000000000000000000000000000000000000000000
00001111111110111000111100000000000000000000000000000000000000000000000000000000
01001111111100110000110000000000000000000000000000000000000000000000000000000000
01111111111100110001100000000000000000000000000000000000000000000000000000000000
00111111100001110001111000000000000000000000000000000000000000000000000000000000
00111111000011111111110000000000000000000000000000000000000000000000000000000000
00111111001110011101100000000000000000000000000000000000000000000000000000000000
01111110011100111000100000000000000000000000000000000000000000000000000000000000
01111100011001110000110000000000000000000000000000000000000000000000000000000000
01001100011011100000000000000000000000000000000000000000000000000000000000000000
01001111111111001100000000000000000000000000000000000000000000000000000000000000
00001100011111111110001000100000000000000000000000000000000000000000000000000000
00001110001111111111111111100000000000000000000000000000000000000000000000000000
00000110001101110010000111100000000000000000000000000000000000000000000000000000
00000010001000000000011111100000000000000000000000000000000000000000000000000000
00000011000000000001110011000000000000000000000000000000000000000000000000000000
00000010000000000001100000000000000000000000000000000000000000000000000000000000
00000000000000000000100000000000000000000000000000000000000000000000000000000000
00000000000000000000000000000000000000000000000000000000000000000000000000000000
00000000000000000000000000000000000000000000000000000000000000000000000000000000
00000000000000000000000000000000000000000000000000000000000000000000000000000000
00000000000000000000000000000000000000000000000000000000000000000000000000000000
00000000000000000000000000000000000000000000000000000000000000000000000000000000
00000000000000000000000000000000000000000000000000000000000000000000000000000000
00000000000000000000000000000000000000000000000000000000000000000000000000000000
00000000000000000000000000000000000000000000000000000000000000000000000000000000
00000000000000000000000000000000000000000000000000000000000000000000000000000000
00000000000000000000000000000000000000000000000000000000000000000000000000000000
00000000000000000000000000000000000000000000000000000000000000000000000000000000
00000000000000000000000000000000000000000000000000000000000000000000000000000000
00000000000000000000000000000000000000000000000000000000000000000000000000000000
00000000000000000000000000000000000000000000000000000000000000000000000000000000
00000000000000000000000000000000000000000000000000000000000000000000000000000000
00000000000000000000000000000000000000000000000000000000000000000000000000000000
00000000000000000000000000000000000000000000000000000000000000000000000000000000
00000000000000000000000000000000000000000000000000000000000000000000000000000000
00000000000000000000000000000000000000000000000000000000000000000000000000000000
00000000000000000000000000000000000000000000000000000000000000000000000000000000
00000000000000000000000000000000000000000000000000000000000000000000000000000000
00000000000000000000000000000000000000000000000000000000000000000000000000000000
00000000000000000000000000000000000000000000000000000000000000000000000000000000
00000000000000000000000000000000000000000000000000000000000000000000000000000000
00000000000000000000000000000000000000000000000000000000000000000000000000000000
00000000000000000000000000000000000000000000000000000000000000000000000000000000
00000000000000000000000000000000000000000000000000000000000000000000000000000000
00000000000000000000000000000000000000000000000000000000000000000000000000000000
00000000000000000000000000000000000000000000000000000000000000000000000000000000
00000000000000000000000000000000000000000000000000000000000000000000000000000000
00000000000000000000000000000000000000000000000000000000000000000000000000000000
00000000000000000000000000000000000000000000000000000000000000000000000000000000
00000000000000000000000000000000000000000000000000000000000000000000000000000000
00000000000000000000000000000000000000000000000000000000000000000000000000000000
00000000000000000000000000000000000000000000000000000000000000000000000000000000
00000000000000000000000000000000000000000000000000000000000000000000000000000000
00000000000000000000000000000000000000000000000000000000000000000000000000000000
00000000000000000000000000000000000000000000000000000000000000000000000000000000
00000000000000000000000000000000000000000000000000000000000000000000000000000000
00000000000000000000000000000000000000000000000000000000000000000000000000000000
00000000000000000000000000000000000000000000000000000000000000000000000000000000
00000000000000000000000000000000000000000000000000000000000000000000000000000000
00000000000000000000000000000000000000000000000000000000000000000000000000000000
00000000000000000000000000000000000000000000000000000000000000000000000000000000
