80 80
00000000000000000000000000000000000000000000000000000000000000000000000000000000
00000000000000000000000000000000000000000000000000000000000000000000000000000000
00000000000000000000000000000000000000000000000001000000000000000000000000000000
00000000000000000000000000000000000000000000011111100000000000000000000000000000
00000000000000000000000000000000000000000000011110100000000000000000000000000000
00000000000000000000000000000010000000000000011111100000000000000000000000000000
00000000000000000000000000000010000000000000110111100000000000000000000000000000
00000000000000000000000000000010000000000000100001000000000000000000000000000000
00000000000000000000000100001111100000000000100000000000000000000000000000000000
00000000000000000000000110011111000110011100110000110010000000000000000000000000
00000000000000000000000011110111011111111100111001111111100000000000000000000000
00000000000000000000000000000111011111111110011001101111000000000000000000000000
00000000000000000000000000000111100111000010011111000111100000000000000000000000
00000000000000000000000000000011110111100001011110000111000000000000000000000000
00000000000000000000000000000011111111111011111111011111000000000000000000000000
00000000000000000000000011111111111110011111111111111111100000000000000000000000
00000000000000000000000010011110111110001111112111110000110000000000000000000000
00000000000000000000000000001111111100000111111111110000000000000000000000000000
00000000000000000000000000111111111000001101111111111000000000000000000000000000
00000000000000000000000001111111011100011100111011111111100000000000000000000000
00000000000000000000000001011110001110011100111111111111111111000000000000000000
00000000000000000000000001011111000111011100011111111111110000000000000000000000
00000000000000000000000000011111111111111111111111000111110000000000000000000000
00000000000000000000000000001111111111111111111111100111000000000000000000000000
00000000000000000000000000000110011101111000011111110011000000000000000000000000
00000000000000000000000000000011111111111100011111110011100000000000000000000000
00000000000000000000000000000011110111011000110011110000110000000000000000000000
00000000000000000000000000000110010011000000110011100000010000000000000000000000
00000000000000000000000000000100000001111011111000000000000000000000000000000000
00000000000000000000000000000110000011111101111100110000000000000000000000000000
00000000000000000000000000000010001111111111111111110000000000000000000000000000
00000000000000000000000000000011111110011111111111000000000000000000000000000000
00000000000000000000000000000011111110000011111100000000000000000000000000000000
00000000000000000000000000000010000110000001110000000000000000000000000000000000
00000000000000000000000000000010000100000011110000000000000000000000000000000000
00000000000000000000000000000110001110011110010000000000000000000000000000000000
00000000000000000000000000000011000000000000000000000000000000000000000000000000
00000000000000000000000000000011100000000000000000000000000000000000000000000000
00000000000000000000000000000000100000000000000000000000000000000000000000000000
00000000000000000000000000000000000000000000000000000000000000000000000000000000
00000000000000000000000000000000000000000000000000000000000000000000000000000000
00000000000000000000000000000000000000000000000000000000000000000000000000000000
00000000000000000000000000000000000000000000000000000000000000000000000000000000
00000000000000000000000000000000000000000000000000000000000000000000000000000000
00000000000000000000000000000000000000000000000000000000000000000000000000000000
00000000000000000000000000000000000000000000000000000000000000000000000000000000
00000000000000000000000000000000000000000000000000000000000000000000000000000000
00000000000000000000000000000000000000000000000000000000000000000000000000000000
00000000000000000000000000000000000000000000000000000000000000000000000000000000
00000000000000000000000000000000000000000000000000000000000000000000000000000000
00000000000000000000000000000000000000000000000000000000000000000000000000000000
00000000000000000000000000000000000000000000000000000000000000000000000000000000
00000000000000000000000000000000000000000000000000000000000000000000000000000000
00000000000000000000000000000000000000000000000000000000000000000000000000000000
00000000000000000000000000000000000000000000000000000000000000000000000000000000
00000000000000000000000000000000000000000000000000000000000000000000000000000000
00000000000000000000000000000000000000000000000000000000000000000000000000000000
00000000000000000000000000000000000000000000000000000000000000000000000000000000
00000000000000000000000000000000000000000000000000000000000000000000000000000000
00000000000000000000000000000000000000000000000000000000000000000000000000000000
00000000000000000000000000000000000000000000000000000000000000000000000000000000
00000000000000000000000000000000000000000000000000000000000000000000000000000000
00000000000000000000000000000000000000000000000000000000000000000000000000000000
00000000000000000000000000000000000000000000000000000000000000000000000000000000
00000000000000000000000000000000000000000000000000000000000000000000000000000000
00000000000000000000000000000000000000000000000000000000000000000000000000000000
00000000000000000000000000000000000000000000000000000000000000000000000000000000
00000000000000000000000000000000000000000000000000000000000000000000000000000000
00000000000000000000000000000000000000000000000000000000000000000000000000000000
00000000000000000000000000000000000000000000000000000000000000000000000000000000
00000000000000000000000000000000000000000000000000000000000000000000000000000000
00000000000000000000000000000000000000000000000000000000000000000000000000000000
00000000000000000000000000000000000000000000000000000000000000000000000000000000
00000000000000000000000000000000000000000000000000000000000000000000000000000000
00000000000000000000000000000000000000000000000000000000000000000000000000000000
00000000000000000000000000000000000000000000000000000000000000000000000000000000
00000000000000000000000000000000000000000000000000000000000000000000000000000000
00000000000000000000000000000000000000000000000000000000000000000000000000000000
00000000000000000000000000000000000000000000000000000000000000000000000000000000
00000000000000000000000000000000000000000000000000000000000000000000000000000000
