80 80
00000000000000000000000000000000000000000000000000000000000000000000000000000000
00000000000000000000000000000000000000000000000000000000000000000000000000000000
00000000000000000000000000000000000000000000000000000000000000000000000000000000
00000000000000000000000000000000000000000000000000000000000000000000000000000000
00000000000000000000000000000000000000000000000000000000000000000000000000000000
00000000000000000000000000000000000000000000000000000000000000000000000000000000
00000000000000000000000000000000000000000000000000000000000000000000000000000000
00000000000000000000000000000000000000000000000000000000000000000000000000000000
00000000000000000000000000000000000000000000000000000000000000000000000000000000
00000000001000000000000000000000000000000000000000000000000000000000000000000000
00000000001000000000000000000000000000000000000000000000000000000000000000000000
00000000001000000000000000000000000000000000000000000000000000000000000000000000
00000000011000000000000000000000000000000000000000000000000000000000000000000000
00000000111001100000000000000000000000000000000000000000000000000000000000000000
01110110011001110000000000000000000000000000000000000000000000000000000000000000
01111110001111110000000000000000000000000000000000000000000000000000000000000000
01111100001111011000000000000000000000000000000000000000000000000000000000000000
00111000000010000000000000000000000000000000000000000000000000000000000000000000
00111000100010000000000000000000000000000000000000000000000000000000000000000000
01111100101111100000000000000000000000000000000000000000000000000000000000000000
01001111111111111110000000000000000000000000000000000000000000000000000000000000
00000111111011001111000000000000000000000000000000000000000000000000000000000000
00000011111110000000000000000000000000000000000000000000000000000000000000000000
01000001111111000000000000000000000000000000000000000000000000000000000000000000
01111101111110010001100000000000000000000000000000000000000000000000000000000000
01111111111110110001110000000000000000000000000000000000000000000000000000000000
01110111111111110000110000000000000000000000000000000000000000000000000000000000
01110000001111100001100000000000000000000000000000000000000000000000000000000000
01100000001111100111100000000000000000000000000000000000000000000000000000000000
00001100001111011100100000000000000000000000000000000000000000000000000000000000
01111110011111111000100000000000000000000000000000000000000000000000000000000000
01100111111111100000100000000000000000000000000000000000000000000000000000000000
01000111111111000001100000000000000000000000000000000000000000000000000000000000
00000110011111000011111100000000000000000000000000000000000000000000000000000000
00001100001111111111110000000001000000000000000000000000000000000000000000000000
00000100001101111111110000000111000000000000000000000000000000000000000000000000
00001100011101111001110000000110000000000000000000000000000000000000000000000000
00111100011001110001110000001110000000000000000000000000000000000000000000000000
01110000011111110000110000001100000000000000000000000000000000000000000000000000
01110010011111110000110011101100000000000000000000000000000000000000000000000000
01111110011111111000110111100111000000000000000000000000000000000000000000000000
01111000011111111001110111100001000000000000000000000000000000000000000000000000
00111000111111111101111111000011000000000000000000000000000000000000000000000000
00001100011111111111111110000111000000000000000000000000000000000000000000000000
00001110001111111111111111100110000000000000000000000000000000000000000000000000
00000110011111111111111111111111111110000000000000000000000000000000000000000000
00001100011111111111111111111111110011000000000000000000000000000000000000000000
00001110011111111110001111111111100001000000000000000000000000000000000000000000
00000111111111111000000111011111100001100000000000000000000000000000000000000000
00001111111100111000111111111111110111110000010000000000000000000000000000000000
00001111111100111111111111111111111110111100010000000000000000000000000000000000
00011111111100011111111111111011111100001110110000000000000000000000000000000000
00010000111100011111111111110001111000101111100000000000000000000000000000000000
00000000111000011111111111110001110111100000000000000000000000000000000000000000
00000001111000111111111111111111100110000000000000000000000000000000000000000000
00001111111111111111111111111111111110000000000000000000000000000000000000000000
00000001011111111111111111111111011100000000000000000000000000000000000000000000
00000111111111111111111111111000011100000000000000000000000000000000000000000000
00000111111111110011111111111100011110000000000000000000000000000000000000000000
00000101111111111001111111111111111111001100000000000000000000000000000000000000
00000100111111111111111111111111111111011110000000000000000000000000000000000000
00000000001001111111111111111111111111111000000000000000000000000000000000000000
00000000000001111110111111111111111111100000000000000000000000000000000000000000
00000000000000111110111111111100011110000000000000000000000000000000000000000000
00011000100000111001111111111110011110000100000000000000000000000000000000000000
00001111111111111001112111111111111111111100000000000000000000000000000000000000
00000011100000111001111111111111111111110000000000000000000000000000000000000000
00000000100000011101111111111111101111000000000000000000000000000000000000000000
00000000000000011110111111111111011110000000000000000000000000000000000000000000
00000000000000011111111111100111111110000000000000000000000000000000000000000000
00000000000000011011111111101111111100000000000000000000000000000000000000000000
00000000000000011011101111111111111100000000000000000000000000000000000000000000
00000000000000011100001111111111111100000000000000000000000000000000000000000000
00000000000010001111100011111100000100000000000000000000000000000000000000000000
00000000000111011111110001111100000100000000000000000000000000000000000000000000
00000000000001111111110001000111101100000000000000000000000000000000000000000000
00000000000001111011111011000000100100000000000000000000000000000000000000000000
00000000000001111011111100000000110000000000000000000000000000000000000000000000
00000000000001011001100000000000100000000000000000000000000000000000000000000000
00000000000000000000000000000000000000000000000000000000000000000000000000000000
