80 80
00000000000000000000000000000000000000000000000000000000000000000000000000000000
00000000000000000000000000000000011000000000111111111111111111101110011000000000
00000000000000000000000000000000010000000000001111111111111111111110011100000000
00000000000000000000000000000000011000000000000111111111111111111111111110000000
00000000000000000000000000000000001100001100001101111111111111111111111111000000
00000000000000000000000000000000001110011101111101111111111111111111111111111000
00000000000000000000000000000000000110011111111001111111111111111111111111100000
00000000000000000000000000000000001111111111110001110111111111111111111110000000
00000000000000000000000000000000001100111111111001100111111111111111111110000000
00000000000000000000000000000000001100111111111001111111111111011111111110011000
00000000000000000000000000000000000111011111111001111111111111001111111111111110
00000000000000000000000000000000000110011111110000111111111111001111111101111110
00000000000000000000000000000000000111011111000000111111111111000111110001111110
00000000000000000000000000000000000000011111000001111111111111100011110001111110
00000000000000000000000000000000000000011111110001111111111111111111111001111110
00000000000000000000000000000000000000011101111111111111111111111111111101111110
00000000000000000000000000000000000000001100111001111111111111111111111111100000
00000000000000000000000000000000000000001110011000111111111211111101100111000000
00000000000000000000000000000000000000011111110000111111111111111101110010000000
00000000000000000000000000000000000000011111110001111111111111111111111000000000
00000000000000000000000000000000000000011110111011111111111111111111011100000000
00000000000000000000000000000000000000001100011111110111111111111111011100000000
00000000000000000000000000000000000000000000001111000111111111111111111100000000
00000000000000000000000000000000000000000000000001000111111111111111111100000000
00000000000000000000000000000000000000000000000001100011111111011111111110011000
00000000000000000000000000000000000000000000000001110011111111111111011111111000
00000000000000000000000000000000000000000000000000110001110111111111011111110000
00000000000000000000000000000000000000000000000000111000000110011111100110010000
00000000000000000000000000000000000000000000000011111000000100001110000110000000
00000000000000000000000000000000000000000000000001101101001110011100001100000000
00000000000000000000000000000000000000000000000000111111111111111110011100000000
00000000000000000000000000000000000000000000000000111111001111110111111000000000
00000000000000000000000000000000000000000000000000001100001111110011110011000000
00000000000000000000000000000000000000000000000000001110000000111100000010000000
00000000000000000000000000000000000000000000000000001111000010011111011111000000
00000000000000000000000000000000000000000000000001111011001111111111111111111000
00000000000000000000000000000000000000000000000000111111111101001111111110001100
00000000000000000000000000000000000000000000000000001111111000001111111110000000
00000000000000000000000000000000000000000000000000111101111000001111111110000000
00000000000000000000000000000000000000000000010001111001111111101110111111111100
00000000000000000000000000000000000000000000011011111111100111111110011111111110
00000000000000000000000000000000000000000000011111111111000011111110001011111110
00000000000000000000000000000000000000000000001111101100000010110110000001100000
00000000000000000000000000000000000000000000000011000100000101100110000001100000
00000000000000000000000000000000000000000000000001100011001111100110000000010000
00000000000000000000000000000000000000000000000000100011111111000100011110110000
00000000000000000000000000000000000000000000000000110001111111001100000111110000
00000000000000000000000000000000000000000000000000011001110000000100000001110000
00000000000000000000000000000000000000000000000000001111000000000011100001110000
00000000000000000000000000000000000000000000000000001111000111100111111011110000
00000000000000000000000000000000000000000000000000000011101111111110011111110010
00000000000000000000000000000000000000000000000000000001111111111100001110011110
00000000000000000000000000000000000000000000000000000001110100011100000001111100
00000000000000000000000000000000000000000000000000000001100000011110000001101000
00000000000000000000000000000000000000000000000001000011100010011111110000001000
00000000000000000000000000000000000000000000000011110011000011111111111110111000
00000000000000000000000000000000000000000000000000111011100011111111101100000000
00000000000000000000000000000000000000000000000000011111100011111111110000000000
00000000000000000000000000000000000000000000000000111111111100000111110000000000
00000000000000000000000000000000000000000000000000111111111110000110011000010000
00000000000000000000000000000000000000000000000001111111111111001110001000010000
00000000000000000000000000000000000000000000000011111111110001111100001000010000
00000000000000000000000000000000000000000000000011111111100000111100001100110000
00000000000000000000000000000000000000000000000001111111000000111000001111100100
00000000000000000000000000000000000000000000000000111111100001101100001111111100
00000000000000000000000000000000000000000000000001111111111111001100011111111100
00000000000000000000000000000000000000000000000001100011111110001110010000110000
00000000000000000000000000000000000000000000000011100011111100001111000000000000
00000000000000000000000000000000000000000000000001111111111111111111000000000000
00000000000000000000000000000000000000000000000000111111111111111110000110011110
00000000000000000000000000000000000000000000000000111111111111111110011111111110
00000000000000000000000000000000000000000000000000000101111111111100111000100000
00000000000000000000000000000000000000000000000000000000001000111000110000000010
00000000000000000000000000000000000000000000000000000000001100011100111001000010
00000000000000000000000000000000000000000000000000000000000111111100111111100010
00000000000000000000000000000000000000000000000000000000000111111110111100111010
00000000000000000000000000000000000000000000000000000000000011100111111100001110
00000000000000000000000000000000000000000000000000000000000011000011111100000010
00000000000000000000000000000000000000000000000000000000000111000001011100000000
00000000000000000000000000000000000000000000000000000000000000000000000000000000
