80 80
00000000000000000000000000000000000000000000000000000000000000000000000000000000
00000000000000000000000000000000000000000000000000000000000000000000000000000000
00000000000000000000000000000000000000000000000000000000000000000000000000000000
00000000000000000000000000000000000000000000000000000000000000000000000000000000
00000000000000000000000000000000000000000000000000000000000000000000000000000000
00000000000000000000000000000000000000000000000000000000000000000000000000000000
00000000000000000000000000000000000000000000000000000000000000000000000000000000
00000000000000000000000000000000000000000000000000000000000000000000000000000000
00000000000000000000000000000000000000000000000000000000000000000000000000000000
00000000000000000000000000000000000000000000000000000000000000000000000000000000
00000000000000000000000000000000000000000000000000000000000000000000000000000000
00000000000000000000000000000000000000000000000000000000000000000000000000000000
00000000000000000000000000000000000000000000000000000000000000000000000000000000
00000000000000000000000000000000000000000000000000000000000000000000000000000000
00000000000000000000000000000000000000000000000000000000000000000000000000000000
00000000000000000000000000000000000000000000000000000000000000000000000000000000
00000000000000000000000000000000000000000000000000000000000000000000000000000000
00000000000000000000000000000000000000000000000000000000000000000000000000000000
00000000000000000000000000000000000000000000000000000000000000000000000000000000
00000000000000000000000000000000000000000000000000000000000000000000000000000000
00000000000000000000000000000000000000000000000000000000000000000000011000010000
00000000000000000000000000000000000000000000000000000000000000000001111101110000
00000000000000000000000000000000000000000000000000000000000000000000111001000000
00000000000000000000000000000000000000000000000000000000000000000000110001001110
00000000000000000000000000000000000000000000000000000000000000000001111111111110
00000000000000000000000000000000000000000000000000000000000000000000111111111110
00000000000000000000000000000000000000000000000000000000000000000000000011111110
00000000000000000000000000000000000000000000000000000000000000000000000011111110
00000000000000000000000000000000000000000000000000000000000000000000000011111110
00000000000000000000000000000000000000000000000000000000000000000000000111111110
00000000000000000000000000000000000100000000000000000000000000000000011111111110
00000000000000000000000000000001000100000000000000000000000000000000000111111000
00000000000000000000000000000001000111000000000000000000000000000000000011000000
00000000000000000000000000000011000111000000000000000000000000000000000011000000
00000000000000000000000000000010001111001000000000000000000000010001100111111000
00000000000000000000000000000011011111001000000000000000000010011111111111111110
00000000000000000000010000000011111111011000000000000000000011000001111111111110
00000000000000000000010000000001110000111000000000000000000011000001100011111110
00000000000000000011111100000011110001111110000000000000001111000001001111111000
00000000000000000000110111001111111111111100000000000000000111001111001100110000
00000000000000000000100001011111111111111000000000000011111111111110011000011000
00000000000000000000100001111111111100011100000000000000000011111110011000011110
00000000000000000000000011111111111000001111100000000000000011111111001100001010
00000000000000000000000000011111111000001111110000000000000111111111101100000000
00000000000000000000000001001110011100001100111000000000000111111111101100000000
00000000000000000000000001110010001110011100111000100011100111111111111000000000
00000000000000000000000001011011000111111101111000110001110111111111111000000000
00000000000000000000000000011111000011111111111110111001111111111110000000000000
00000000000000000000000000001111111111111111111111111011111111111111100000000000
00000000000000000000000000111111111111111111111001111011011111111111110000000000
00000000000000000000000011111111111111111111111111111011111111111111111100000000
00000000000000000000000000001111111100111111111111111001111111111111111100000000
00000000000000000000000000000111111000100111111111111111111111111111100000000000
00000000000000000000000000000011100000000011111111211111100110011110100000000000
00000000000000000000000000100111000000000011111111111111000010001111110000000000
00000000000000000000000011111111000000000000111111111111000010001111111100000000
00000000000000000000000000011110000000000000100001111111000000000111011000000000
00000000000000000000000000001110000000000000000000111100000000000111110000000000
00000000000000000000000000000011000000000000000000111100000000011111110000000000
00000000000000000000000000000001000000000000000000111000000000000100010000000000
00000000000000000000000000000000000000000000000000111000000000000100011000000000
00000000000000000000000000000000000000000000000000111000000000000100000000000000
00000000000000000000000000000000000000000000000000000000000000000000000000000000
00000000000000000000000000000000000000000000000000000000000000000000000000000000
00000000000000000000000000000000000000000000000000000000000000000000000000000000
00000000000000000000000000000000000000000000000000000000000000000000000000000000
00000000000000000000000000000000000000000000000000000000000000000000000000000000
00000000000000000000000000000000000000000000000000000000000000000000000000000000
00000000000000000000000000000000000000000000000000000000000000000000000000000000
00000000000000000000000000000000000000000000000000000000000000000000000000000000
00000000000000000000000000000000000000000000000000000000000000000000000000000000
00000000000000000000000000000000000000000000000000000000000000000000000000000000
00000000000000000000000000000000000000000000000000000000000000000000000000000000
00000000000000000000000000000000000000000000000000000000000000000000000000000000
00000000000000000000000000000000000000000000000000000000000000000000000000000000
00000000000000000000000000000000000000000000000000000000000000000000000000000000
00000000000000000000000000000000000000000000000000000000000000000000000000000000
00000000000000000000000000000000000000000000000000000000000000000000000000000000
00000000000000000000000000000000000000000000000000000000000000000000000000000000
00000000000000000000000000000000000000000000000000000000000000000000000000000000
