80 80
00000000000000000000000000000000000000000000000000000000000000000000000000000000
00000000000000000000000000000000000000000000000000000000000000000000000000000000
00000000000000000000000000000000000000000000000000000000000000000000000000000000
00000000000000000000000000000000000000000000000000000000000000000000000000000000
00000000000000000000000000000000000000000000000000000000000000000000000000000000
00000000000000000000000000000000000000000000000000000000000000000000000000000000
00000000000000000000000000000000000000000000000000000000000000000000000000000000
00000000000000000000000000000000000000000000000000000000000000000000000000000000
00000000000000000000000000000000000000000000000000000000000000000000000000000000
00000000000000000000000000000000000000000000000000000000000000000000000000000000
00000000000000000000000000000000000000000000000000000000000000000000000000000000
00000000000000000000000000000000000000000000000000000000000000000000000000000000
00000000000000000000000000000000000000000000000000000000000000000000000000000000
00000000000000000000000000000000000000000000000000000000000000000000000000000000
00000000000000000000000000000000000000000000000000000000000000000000000000000000
00000000000000000000000000000000000000000000000000000000000000000000000000000000
00000000000000000000000000000000000000000000000000000000000000000000000000000000
00000000000000000000000000000000000000000000000000000000000000000000000000000000
00000000000000000000000000000000000000000000000000000000000000000000000000000000
00000000000000000000000000000000000000000000000000000000000000000000000000000000
00000000000000000000000000000000000000000000000000000000000000000000000000000000
00000000000000000000000000000000000000000000000000000000000000000000000000000000
00000000000000000000000000000000000000000000000000000000000000000000000000000000
00000000000000000000000000000000000000000000000000000000000000000000000000000000
00000000000000000000000000000000000000000000000000000000000000000000000000000000
00000000000000000000000000000000000000000000000000000000000000000000000000000000
00000000000000000000000000000000000000000000000000000000000000000000000000000000
00000000000000000000000000000000000000000000000000000000000000000000000000000000
00000000000000000000000000000000000000000000000000000000000000000000000000000000
00000000000000000000000000000000000000000000000000000000000000000000000000000000
00000000000000000000000000000000000000000000000000000000000000000000000000000000
00000000000000000000000000000000000000000000000000000000000000000000000000000000
00000000000000000000000000000000000000000000000000000000000000000000010000000000
00000000000000000000000000000000000000000000000000000000000000000000011000000000
00000000000000000000000000000000000000000000000000000000000000000000001000000000
00000000000000000000000000000000000000000000000000000000000000000000001000000000
00000000000000000000000000000000000000000000000000000000000000000000001000000000
00000000000000000000000000000000000000000000000000000000000000000001111110000000
00000000000000000000000000000000000000000000000000000000000000000001101110000000
00000000000000000000000000000000000000000000000000000000000000000001111100010000
00000000000000000000000000000000000000000000000000000000000000001111111100010000
00000000000000000000000000000000000000000000000000000000000000000001111110110000
00000000000000000000000000000000000000000000000000000000000000000000100111100000
00000000000000000000000000000000000000000000000000000000000000000001101111100000
00000000000000000000000000000000000000000000000000000000000000011011001100110000
00000000000000000000000000000000000000000000000000000000000000011110011000111000
00000000000000000000000000000000000000000000000000000000000000000100011000000000
00000000000000000000000000000000000000000000000000000000000000000000011000000000
00000000000000000000000000000000000000000000000000000000000000000100111000000110
00000000000000000000000000000000000000000000000000000000000000001111111110011100
00000000000000000000000000000000000000000000000000000000000111101111111111111000
00000000000000000000000000000000000000000000000000000000000001111111111111110000
00000000000000000000000000000000000000000000000000000000000001101111111111000000
00000000000000000000000000000000000000000000000000000000000111000100011111000000
00000000000000000000000000000000000000111000000000000001000111100100001111010000
00000000000000000000000000000000000000111100000000100001100111111110011111111000
00000000000000000000000000000000000000001100000000100001000011111100011101100000
00000000000000000000000000000000000000111110000001111111000011111000011100000010
00000000000000000000000000000000000000011001110011110011110011110000011100000010
00000000000000000000000000000000000000001011110011100001111111111100011100000110
00000000000000000000000000000000000000001111011111100011111111111111011111111110
00000000000000000000000000000000000000001111011110110011111111111111111111101110
00000000000000000000000000000000000000011110011100110111111110011101111111000010
00000000000000000000000000000000000000001111111000111111111111011111111111000000
00000000000000000000000000000000000000001101111000111111100111001111111111110000
00000000000000000000000000000000000000001001111001111111100111001111111100111000
00000000000000000000000000000000000000011001111001111111100111001111111110011010
00000000000000000000000000000000000000011001001000001111000110001111111110011110
00000000000000000000000000010000010001101011001000001111001110011111111111111110
00000000000000000000000000011001111101111111011001111111111110011111121111111110
00000000000000000000000000001111001111011100111011111111111111011111111111111000
00000000000000000000000000001100000111001100010011111111111011111111111111111000
00000000000000000000000000001000000110000000000011101100011011111111111111110000
00000000000000000000000000000000000000000000001111111110001111111111011111110010
00000000000000000000000000000000000000000000011111110011001111111110011111111110
00000000000000000000000000000000000000000000111111110001101111111110011111111110
00000000000000000000000000000000000000000000111001110001111111110100001111111110
00000000000000000000000000000000000000000000110000100000111100000000001111100000
00000000000000000000000000000000000000000000110000000000111000000000001101100000
00000000000000000000000000000000000000000000000000000000000000000000000000000000
