80 80
00000000000000000000000000000000000000000000000000000000000000000000000000000000
00000000000000000000000000000000000000000000000000000000000000000000000000000000
00000000000000000000000000000000000000000000000000000000000000000000000000000000
00000000000000000000000000000000000000000000000000000000000000000000000000000000
00000000000000000000000000000000000000000000000000000000000000000000000000000000
00000000000000000000000000000000000000000000000000000000000000000000000000010000
00000000000000000000000000000000000000000000000000000000000000000000000000011000
00000000000000000000000000000000000000000000000000000000000000000000000011111000
00000000000000000000000000000000000000000000000000000000000000000000000111111000
00000000000000000000000000000000000000000000000000000000000000000000001001011000
00000000000000000000000000000000000000000000000000000000000000000000001001111000
00000000000000000000000000000000000000000000000000000000000000000000001101110110
00000000000000000000000000000000000000000000000000000000000000000000000111111110
00000000000000000000000000000000000000000000000000000000000000000000100000111110
00000000000000000000000000000000000000000000000000000000000000000000111000100110
00000000000000000000000000000000000000000000000000000000000000001110011111111110
00000000000000000000000000000000000000000000000000000000000000000111001111001000
00000000000000000000000000000000000000000000000000000000000000000110000001000010
00000000000000000000000000000000000000000000000000000000000000001110000011100010
00000000000000000000000000000000000000000000000000000000000000000110000111110010
00000000000000000000000000000000000000000000000000000000000000001111111110111110
00000000000000000000000000000000000000000000000000000000000000000110110000010110
00000000000000000000000000000000000000000000000000000000000000111111100000000010
00000000000000000000000000000000000000000000000000000000000000011111110001100010
00000000000000000000000000000000000000000000000000000000000000001100011011110000
00000000000000000000000000000000000000000000111000000000000011000100011111111000
00000000000000000000000000000000000000000000001000000000000011000110001101111000
00000000000000000000000000000000000000000000001000000000011111111110001000000000
00000000000000000000000000000000000000000001111000000000000011111110011000000000
00000000000000000000000000000000000000000001111110000000000011100111111000110000
00000000000000000000000000000000000000000001111011111111100010001111111101111000
00000000000000000000000000000000000000000000110000011111111110011001101111111100
00000000000000000000000000000000000000000000000000011111001000000000000000001100
00000000000000000000000000000000000000000000000000011111010000000000000000001100
00000000000000000000000000000000000000000000000000001101110000000000000000011000
00000000000000000000000000000000000000000000000000000011100000000000000000010000
00000000000000000000000000000000000000000000000000000010000000000000000000110000
00000000000000000000000000000000000000000000000000000000000000000000000000111000
00000000000000000000000000000000000000000000000000000000000000000000000001111000
00000000000000000000000000000000000000000000000000000000000000000000000111121000
00000000000000000000000000000000000000000000000000000000000000000000001111111000
00000000000000000000000000000000000000000000000000000000000000000000001000111000
00000000000000000000000000000000000000000000000000000000000000000000000000011100
00000000000000000000000000000000000000000000000000000000000001111110000010011100
00000000000000000000000000000000000000000000000000000000000000011110001110011110
00000000000000000000000000000000000000000000000000000000000000001110001011110000
00000000000000000000000000000000000000000000000000000000000000001110001011110000
00000000000000000000000000000000000000000000000000000000000000011111000111011000
00000000000000000000000000000000000000000000000000000000000000111111000111011110
00000000000000000000000000000000000000000000000000000000000011111111100100110010
00000000000000000000000000000000000000000000000000000000000111011111111100010010
00000000000000000000000000000000000000000000000000000000001110000011110000011010
00000000000000000000000000000000000000000000000000000000001100000001000000000000
00000000000000000000000000000000000000000000000000000000111111000000000000000000
00000000000000000000000000000000000000000000000000000001111111000000000000000000
00000000000000000000000000000000000000000000000000000001011111000000000000000000
00000000000000000000000000000000000000000000000000000011001110000000000000000000
00000000000000000000000000000000000000000000000000000001000000000000000000000000
00000000000000000000000000000000000000000000000000000000000000000000000000000000
00000000000000000000000000000000000000000000000000000000000000000000000000000000
00000000000000000000000000000000000000000000000000000000000000000000000000000000
00000000000000000000000000000000000000000000000000000000000000000000000000000000
00000000000000000000000000000000000000000000000000000000000000000000000000000000
00000000000000000000000000000000000000000000000000000000000000000000000000000000
00000000000000000000000000000000000000000000000000000000000000000000000000000000
00000000000000000000000000000000000000000000000000000000000000000000000000000000
00000000000000000000000000000000000000000000000000000000000000000000000000000000
00000000000000000000000000000000000000000000000000000000000000000000000000000000
00000000000000000000000000000000000000000000000000000000000000000000000000000000
00000000000000000000000000000000000000000000000000000000000000000000000000000000
00000000000000000000000000000000000000000000000000000000000000000000000000000000
00000000000000000000000000000000000000000000000000000000000000000000000000000000
00000000000000000000000000000000000000000000000000000000000000000000000000000000
00000000000000000000000000000000000000000000000000000000000000000000000000000000
00000000000000000000000000000000000000000000000000000000000000000000000000000000
00000000000000000000000000000000000000000000000000000000000000000000000000000000
00000000000000000000000000000000000000000000000000000000000000000000000000000000
00000000000000000000000000000000000000000000000000000000000000000000000000000000
00000000000000000000000000000000000000000000000000000000000000000000000000000000
00000000000000000000000000000000000000000000000000000000000000000000000000000000
