80 80
00000000000000000000000000000000000000000000000000000000000000000000000000000000
00000000000000000000000000000000000000000000000000000000000000000000000000000000
00000000000000000000000000000000000000000000000000000000000000000000000000000000
00000000000000000000000000000000000000000000000000000000000000000000000000000000
00000000000000000000000000000000000000010000000000000000000000000000000000000000
00000000000000000000000000000000000000011100000000000000000000000000000000000000
00000000000000000000000000000001000000011100000000000000000000000000000000000000
00000000000000000000000000000001000000111100000000000000000000000000000000000000
00000000000000000000000000000011000000111100000000000000000000000000000000000000
00000000000001110000000000000010000000001100000000000000000000000000000000000000
00000000000000010000000000000010011111011100000000000000000000000000000000000000
00000000000000011000000000000011111111011100000000000000000000000000000000000000
00000000000000001100000000000001110011111100000000000000000000000000000000000000
00000000000000000110000000000111100000011110000000000000000000000000000000000000
00000000000001100111000001000011000000011100000000000000000000000000000000000000
00000000000000111111111001000010000000011100000000000000000000000000000000000000
00000000000000011111111111000110000000001100000000000000000000000000000000000000
00001000000000001111001110001111000000000100000000000000000000000000000000000000
00001000000000111111100000011011100000000000000000000000000000000000000000000000
00001100011001111111110001110011000000000000000000000000000000000000000000000000
00001110011111111111110011100010000000000000000000000000000000000000000000000000
00000110001111111111111111000110000000000000000000000000000000000000000000000000
00001110000111111111111110000110000000000000000000000000000000000000000000000000
00001110000001111111111111000111100000000000000000000000000000000000000000000000
00011111111100111111111111100111000000000000000000000000000000000000000000000000
01001111111100111111111111101111000000000000000000000000000000000000000000000000
01101111111111111111111111111110000000000000000000000000000000000000000000000000
00111111101111111111111111111111000000000000000000000000000000000000000000000000
00111121111111111111111111000011100000100000000000000000000000000000000000000000
01111111111111111111111111000011110011110000000000000000000000000000000000000000
01111111111111111111111111100011011110111100000000000000000000000000000000000000
00001111111111111111111101100010011000000000000000000000000000000000000000000000
00001100111110001111111000011111000000000000000000000000000000000000000000000000
00111111111100001111101100001111000000000000000000000000000000000000000000000000
01111111111000011111101110001011000000000000000000000000000000000000000000000000
01111111111100111111111111110111000000000000000000000000000000000000000000000000
01111111111100111110111000101110000000000000000000000000000000000000000000000000
00110111111110111110111000001100000000000000000000000000000000000000000000000000
00100011111110111111111100000000000000000000000000000000000000000000000000000000
00110111111111110011111111000000000000000000000000000000000000000000000000000000
01111111111111111011111111100000000000000000000000000000000000000000000000000000
01111101111100011100000001000000000000000000000000000000000000000000000000000000
00001111110000001100000000000000000000000000000000000000000000000000000000000000
00001111000000001000000000000000000000000000000000000000000000000000000000000000
00001110000000011000000000000000000000000000000000000000000000000000000000000000
01111110000000010000000000000000000000000000000000000000000000000000000000000000
00011100000000011000000000000000000000000000000000000000000000000000000000000000
00000000000000000000000000000000000000000000000000000000000000000000000000000000
00000000000000000000000000000000000000000000000000000000000000000000000000000000
00000000000000000000000000000000000000000000000000000000000000000000000000000000
00000000000000000000000000000000000000000000000000000000000000000000000000000000
00000000000000000000000000000000000000000000000000000000000000000000000000000000
00000000000000000000000000000000000000000000000000000000000000000000000000000000
00000000000000000000000000000000000000000000000000000000000000000000000000000000
00000000000000000000000000000000000000000000000000000000000000000000000000000000
00000000000000000000000000000000000000000000000000000000000000000000000000000000
00000000000000000000000000000000000000000000000000000000000000000000000000000000
00000000000000000000000000000000000000000000000000000000000000000000000000000000
00000000000000000000000000000000000000000000000000000000000000000000000000000000
00000000000000000000000000000000000000000000000000000000000000000000000000000000
00000000000000000000000000000000000000000000000000000000000000000000000000000000
00000000000000000000000000000000000000000000000000000000000000000000000000000000
00000000000000000000000000000000000000000000000000000000000000000000000000000000
00000000000000000000000000000000000000000000000000000000000000000000000000000000
00000000000000000000000000000000000000000000000000000000000000000000000000000000
00000000000000000000000000000000000000000000000000000000000000000000000000000000
00000000000000000000000000000000000000000000000000000000000000000000000000000000
00000000000000000000000000000000000000000000000000000000000000000000000000000000
00000000000000000000000000000000000000000000000000000000000000000000000000000000
00000000000000000000000000000000000000000000000000000000000000000000000000000000
00000000000000000000000000000000000000000000000000000000000000000000000000000000
00000000000000000000000000000000000000000000000000000000000000000000000000000000
00000000000000000000000000000000000000000000000000000000000000000000000000000000
00000000000000000000000000000000000000000000000000000000000000000000000000000000
00000000000000000000000000000000000000000000000000000000000000000000000000000000
00000000000000000000000000000000000000000000000000000000000000000000000000000000
00000000000000000000000000000000000000000000000000000000000000000000000000000000
00000000000000000000000000000000000000000000000000000000000000000000000000000000
00000000000000000000000000000000000000000000000000000000000000000000000000000000
00000000000000000000000000000000000000000000000000000000000000000000000000000000
