80 80
00000000000000000000000000000000000000000000000000000000000000000000000000000000
00111110001111111111110011111111000000000000000000000000000000000000000000000000
00011111011110011110111011111111000000000000000000000000000000000000000000000000
00000111111110011111011111111110000000000000000000000000000000000000000000000000
00000110001100011111111111001110000000000000001000100000000000000000000000000000
00000100001100111001111111111111111111111100111000100000000011000000000000000000
00001100011000111000111011111111010001011001100000100000000110000000000000000000
00001000011000111101111111111100000000111111000000110000000110000000000000000000
00001000011001111111111111000000000001111110000001111100011110000000000000000000
00001000011111111001111111110000011111111100010011111111011111111000000000000000
00000000011111111001111111111111111111111100111111111111111111111100000000000000
00000000011111011100111111000000111111111000110111111001111110110110000000000000
00000000011010000110011110000000010001100000100111111000001100110011000000000000
00000000010010000111000110000000000000000000001100111100001000010001000000000000
00000000000000001111100011000001000110010000011000111111001111001100000000000000
00000000000000111111110011100111001110111100010000111111111111000100000000000000
00000000000000100000110001101110001100100100110001111111112111000110000000000000
00000000000000000000010000111111111000100001110011001101111111000110000000000000
00000000000000000000011000111111101000100000111111001111111011111111000000000000
00000000000000000000011001111110001100110000111000111111111011111111111000000000
00000000000000000000000011110010001100011100111001110011111111111111111100000000
00000000000000000000000011110011000110001100111011100001111110011110001100000000
00000000000000000000000010010001000110001111110001110000111110011110000000000000
00000000000000000000000000011001000011111000000011111100001111100111000000000000
00000000000000000000000000011010000111111000011111111111001111110111100000000000
00000000000000000000000000011110000100001000011011111111111111111111000000000000
00000000000000000000000000000000000000000000000001111001111111111101000000000000
00000000000000000000000000000000000000000000000000111001111111111110000000000000
00000000000000000000000000000000000000000000000001110011111001101110000000000000
00000000000000000000000000000000000000000000000001110001101110000110011000000000
00000000000000000000000000000000000000000000000000110001000011001110011100000000
00000000000000000000000000000000000000000000000000110001000011111110011100000000
00000000000000000000000000000000000000000000000000000001111100110111111100000000
00000000000000000000000000000000000000000000000000000000011111110011110000000000
00000000000000000000000000000000000000000000000000000000000011011110011000000000
00000000000000000000000000000000000000000000000000000000000010011110001001111000
00000000000000000000000000000000000000000000000000000000000010000000001111000000
00000000000000000000000000000000000000000000000000000000000011000000000000000000
00000000000000000000000000000000000000000000000000000000000011100010000000000000
00000000000000000000000000000000000000000000000000000000000010110110000000000000
00000000000000000000000000000000000000000000000000000000000010010100000000000000
00000000000000000000000000000000000000000000000000000000000010011100000000000000
00000000000000000000000000000000000000000000000000000000000000000000000000000000
00000000000000000000000000000000000000000000000000000000000000000000000000000000
00000000000000000000000000000000000000000000000000000000000000000000000000000000
00000000000000000000000000000000000000000000000000000000000000000000000000000000
00000000000000000000000000000000000000000000000000000000000000000000000000000000
00000000000000000000000000000000000000000000000000000000000000000000000000000000
00000000000000000000000000000000000000000000000000000000000000000000000000000000
00000000000000000000000000000000000000000000000000000000000000000000000000000000
00000000000000000000000000000000000000000000000000000000000000000000000000000000
00000000000000000000000000000000000000000000000000000000000000000000000000000000
00000000000000000000000000000000000000000000000000000000000000000000000000000000
00000000000000000000000000000000000000000000000000000000000000000000000000000000
00000000000000000000000000000000000000000000000000000000000000000000000000000000
00000000000000000000000000000000000000000000000000000000000000000000000000000000
00000000000000000000000000000000000000000000000000000000000000000000000000000000
00000000000000000000000000000000000000000000000000000000000000000000000000000000
00000000000000000000000000000000000000000000000000000000000000000000000000000000
00000000000000000000000000000000000000000000000000000000000000000000000000000000
00000000000000000000000000000000000000000000000000000000000000000000000000000000
00000000000000000000000000000000000000000000000000000000000000000000000000000000
00000000000000000000000000000000000000000000000000000000000000000000000000000000
00000000000000000000000000000000000000000000000000000000000000000000000000000000
00000000000000000000000000000000000000000000000000000000000000000000000000000000
00000000000000000000000000000000000000000000000000000000000000000000000000000000
00000000000000000000000000000000000000000000000000000000000000000000000000000000
00000000000000000000000000000000000000000000000000000000000000000000000000000000
00000000000000000000000000000000000000000000000000000000000000000000000000000000
00000000000000000000000000000000000000000000000000000000000000000000000000000000
00000000000000000000000000000000000000000000000000000000000000000000000000000000
00000000000000000000000000000000000000000000000000000000000000000000000000000000
00000000000000000000000000000000000000000000000000000000000000000000000000000000
00000000000000000000000000000000000000000000000000000000000000000000000000000000
00000000000000000000000000000000000000000000000000000000000000000000000000000000
00000000000000000000000000000000000000000000000000000000000000000000000000000000
00000000000000000000000000000000000000000000000000000000000000000000000000000000
00000000000000000000000000000000000000000000000000000000000000000000000000000000
00000000000000000000000000000000000000000000000000000000000000000000000000000000
00000000000000000000000000000000000000000000000000000000000000000000000000000000
