80 80
00000000000000000000000000000000000000000000000000000000000000000000000000000000
00000000000000000000000000000000000000000000000000000000000000000000000000000000
00000000000000000000000000000000000000000000000000000000000000000000000000000000
00000000000000000000000000000000000000000000000000000000000000000000000000000000
00000000000000000000000000000000000000000000000000000000000000000000000000000000
00000000000000000000000000000000000000000000000000000000000000000000000000000000
00000000000000000000000000000000000000000000000000000000000000000000000000000000
00000000000000000000000000000000000000000000000000000000000000000000000000000000
00000000000000000000000000000000000000000000000000000000000000000000000000000000
00000000000000000000000000000000000000000000000000000000000000000000000000000000
00000000000000000000000000000000000000000000000000000000000000000000001000000000
00000000000000000000000000000000000000000000000000000000000000000000001100000000
00000000000000000000000000000000000000000000000000000000000000000000001110000000
00000000000000000000000000000000000000000000000000000000000000000001011100000000
00000000000000000000000000000000000000000000000000000000000000000111101100010000
00000000000000000000000000000000000000000000000000000001000000001110011110010000
00000000000000000000000000000000000000000000000000000001100001111100011111110000
00000000000000000000000000000000000000000000000000000000100000111100011111110000
00000000000000000000000000000000000000000000000000000000100000111111111001110000
00000000000000000000000000000000000000000000000000000001100111111111011111110010
00000000000000000000000000000000000000000000000000000001101111111111011111111110
00000000000000000000000000000000000000000000000000000011001111111111111111001110
00000000000000000000000000000000000000000000000000000001111111111111110010000000
00000000000000000000000000000000000000000000000000000001111111011111110001000000
00000000000000000000000000000000000000000000000000000001110110001111111011100000
00000000000000000000000000000000000000000000000000000111110010001111111111111000
00000000000000000000000000000000000000000000000000000111010011001111011111111000
00000000000000000000000000000000000000000000000000000000000011001111111111111100
00000000000000000000000000000000000000000000000000000001000001101111111121111110
00000000000000000000000000000000000000000000000000000001000011111111111111111000
00000000000000000000000000000000000000000000000000000001100111101111111111111000
00000000000000000000000000000000000000000000000000000001111110001111111110011100
00000000000000000000000000000000000000000000000000000000111000011101100000000110
00000000000000000000000000000000000000000000000000000001110000011000110000000010
00000000000000000000000000000000000000000000000000011111100001111110111000000000
00000000000000000000000000000000000000000000000000000011111111111111011000000000
00000000000000000000000000000000000000000000000000000001111100011111001100000000
00000000000000000000000000000000000000000000000000000001100000001111111100000000
00000000000000000000000000000000000000000000000000000000110000000000111111000000
00000000000000000000000000000000000000000000000000000000111011111000001101110000
00000000000000000000000000000000000000000000000000000000001110001100001000110000
00000000000000000000000000000000000000000000000000000000001110000000011000011000
00000000000000000000000000000000000000000000000000000000000000000000000000001000
00000000000000000000000000000000000000000000000000000000000000000000000000011000
00000000000000000000000000000000000000000000000000000000000000000000000000010000
00000000000000000000000000000000000000000000000000000000000000000000000000010000
00000000000000000000000000000000000000000000000000000000000000000000000000010000
00000000000000000000000000000000000000000000000000000000000000000000000000110000
00000000000000000000000000000000000000000000000000000000000000000000000000000000
00000000000000000000000000000000000000000000000000000000000000000000000000000000
00000000000000000000000000000000000000000000000000000000000000000000000000000000
00000000000000000000000000000000000000000000000000000000000000000000000000000000
00000000000000000000000000000000000000000000000000000000000000000000000000000000
00000000000000000000000000000000000000000000000000000000000000000000000000000000
00000000000000000000000000000000000000000000000000000000000000000000000000000000
00000000000000000000000000000000000000000000000000000000000000000000000000000000
00000000000000000000000000000000000000000000000000000000000000000000000000000000
00000000000000000000000000000000000000000000000000000000000000000000000000000000
00000000000000000000000000000000000000000000000000000000000000000000000000000000
00000000000000000000000000000000000000000000000000000000000000000000000000000000
00000000000000000000000000000000000000000000000000000000000000000000000000000000
00000000000000000000000000000000000000000000000000000000000000000000000000000000
00000000000000000000000000000000000000000000000000000000000000000000000000000000
00000000000000000000000000000000000000000000000000000000000000000000000000000000
00000000000000000000000000000000000000000000000000000000000000000000000000000000
00000000000000000000000000000000000000000000000000000000000000000000000000000000
00000000000000000000000000000000000000000000000000000000000000000000000000000000
00000000000000000000000000000000000000000000000000000000000000000000000000000000
00000000000000000000000000000000000000000000000000000000000000000000000000000000
00000000000000000000000000000000000000000000000000000000000000000000000000000000
00000000000000000000000000000000000000000000000000000000000000000000000000000000
00000000000000000000000000000000000000000000000000000000000000000000000000000000
00000000000000000000000000000000000000000000000000000000000000000000000000000000
00000000000000000000000000000000000000000000000000000000000000000000000000000000
00000000000000000000000000000000000000000000000000000000000000000000000000000000
00000000000000000000000000000000000000000000000000000000000000000000000000000000
00000000000000000000000000000000000000000000000000000000000000000000000000000000
00000000000000000000000000000000000000000000000000000000000000000000000000000000
00000000000000000000000000000000000000000000000000000000000000000000000000000000
00000000000000000000000000000000000000000000000000000000000000000000000000000000
